기준일,순서,본인유족구분,연령구분,합계,남,여
2025-04-30,1,본인,0~4세,0,0,0
2025-04-30,2,본인,5~9세,0,0,0
2025-04-30,3,본인,10~14세,0,0,0
2025-04-30,4,본인,15~19세,0,0,0
2025-04-30,5,본인,20~24세,405,391,14
2025-04-30,6,본인,25~29세,6522,6208,314
2025-04-30,7,본인,30~34세,15440,14517,923
2025-04-30,8,본인,35~39세,14650,13715,935
2025-04-30,9,본인,40~44세,15061,14342,719
2025-04-30,10,본인,45~49세,15555,14825,730
2025-04-30,11,본인,50~54세,16606,16229,377
2025-04-30,12,본인,55~59세,20282,19900,382
2025-04-30,13,본인,60~64세,22883,22330,553
2025-04-30,14,본인,65~69세,24304,23895,409
2025-04-30,15,본인,70~74세,30675,30482,193
2025-04-30,16,본인,75~79세,118483,118254,229
2025-04-30,17,본인,80~84세,51354,51194,160
2025-04-30,18,본인,85~89세,10979,10679,300
2025-04-30,19,본인,90~94세,23533,22938,595
2025-04-30,20,본인,95~99세,6811,6699,112
2025-04-30,21,본인,100세이상,463,453,10
2025-04-30,22,본인,해당없음,0,0,0
2025-04-30,23,유족,0~4세,0,0,0
2025-04-30,24,유족,5~9세,4,2,2
2025-04-30,25,유족,10~14세,15,9,6
2025-04-30,26,유족,15~19세,30,22,8
2025-04-30,27,유족,20~24세,84,45,39
2025-04-30,28,유족,25~29세,109,68,41
2025-04-30,29,유족,30~34세,325,185,140
2025-04-30,30,유족,35~39세,556,312,244
2025-04-30,31,유족,40~44세,1650,939,711
2025-04-30,32,유족,45~49세,4002,2473,1529
2025-04-30,33,유족,50~54세,8605,5481,3124
2025-04-30,34,유족,55~59세,13724,9067,4657
2025-04-30,35,유족,60~64세,25369,16583,8786
2025-04-30,36,유족,65~69세,45536,26596,18940
2025-04-30,37,유족,70~74세,49681,20404,29277
2025-04-30,38,유족,75~79세,42406,14113,28293
2025-04-30,39,유족,80~84세,22251,4380,17871
2025-04-30,40,유족,85~89세,30614,1911,28703
2025-04-30,41,유족,90~94세,21605,610,20995
2025-04-30,42,유족,95~99세,3878,107,3771
2025-04-30,43,유족,100세이상,492,60,432
2025-04-30,44,유족,해당없음,0,0,0
2025-03-31,1,본인,0~4세,0,0,0
2025-03-31,2,본인,5~9세,0,0,0
2025-03-31,3,본인,10~14세,0,0,0
2025-03-31,4,본인,15~19세,0,0,0
2025-03-31,5,본인,20~24세,402,386,16
2025-03-31,6,본인,25~29세,"6,503","6,183",320
2025-03-31,7,본인,30~34세,"15,427","14,510",917
2025-03-31,8,본인,35~39세,"14,577","13,637",940
2025-03-31,9,본인,40~44세,"15,039","14,320",719
2025-03-31,10,본인,45~49세,"15,506","14,785",721
2025-03-31,11,본인,50~54세,"16,442","16,077",365
2025-03-31,12,본인,55~59세,"20,235","19,854",381
2025-03-31,13,본인,60~64세,"22,933","22,384",549
2025-03-31,14,본인,65~69세,"24,368","23,958",410
2025-03-31,15,본인,70~74세,"31,379","31,183",196
2025-03-31,16,본인,75~79세,"119,734","119,511",223
2025-03-31,17,본인,80~84세,"49,731","49,572",159
2025-03-31,18,본인,85~89세,"11,032","10,726",306
2025-03-31,19,본인,90~94세,"24,071","23,471",600
2025-03-31,20,본인,95~99세,"6,737","6,626",111
2025-03-31,21,본인,100세이상,447,438,9
2025-03-31,22,본인,해당없음,0,0,0
2025-03-31,23,유족,0~4세,0,0,0
2025-03-31,24,유족,5~9세,5,2,3
2025-03-31,25,유족,10~14세,14,9,5
2025-03-31,26,유족,15~19세,32,23,9
2025-03-31,27,유족,20~24세,84,45,39
2025-03-31,28,유족,25~29세,109,68,41
2025-03-31,29,유족,30~34세,327,186,141
2025-03-31,30,유족,35~39세,558,311,247
2025-03-31,31,유족,40~44세,"1,672",960,712
2025-03-31,32,유족,45~49세,"4,013","2,480","1,533"
2025-03-31,33,유족,50~54세,"8,627","5,505","3,122"
2025-03-31,34,유족,55~59세,"13,706","9,056","4,650"
2025-03-31,35,유족,60~64세,"25,466","16,623","8,843"
2025-03-31,36,유족,65~69세,"45,453","26,491","18,962"
2025-03-31,37,유족,70~74세,"49,567","20,288","29,279"
2025-03-31,38,유족,75~79세,"41,793","13,899","27,894"
2025-03-31,39,유족,80~84세,"22,200","4,315","17,885"
2025-03-31,40,유족,85~89세,"30,897","1,916","28,981"
2025-03-31,41,유족,90~94세,"21,439",605,"20,834"
2025-03-31,42,유족,95~99세,"3,836",106,"3,730"
2025-03-31,43,유족,100세이상,490,62,428
2025-03-31,44,유족,해당없음,0,0,0
2025-02-28,1,본인,0~4세,0,0,0
2025-02-28,2,본인,5~9세,0,0,0
2025-02-28,3,본인,10~14세,0,0,0
2025-02-28,4,본인,15~19세,0,0,0
2025-02-28,5,본인,20~24세,395,382,13
2025-02-28,6,본인,25~29세,6348,6063,285
2025-02-28,7,본인,30~34세,15182,14282,900
2025-02-28,8,본인,35~39세,14527,13592,935
2025-02-28,9,본인,40~44세,15047,14327,720
2025-02-28,10,본인,45~49세,15474,14757,717
2025-02-28,11,본인,50~54세,16319,15967,352
2025-02-28,12,본인,55~59세,20230,19847,383
2025-02-28,13,본인,60~64세,22927,22382,545
2025-02-28,14,본인,65~69세,24562,24153,409
2025-02-28,15,본인,70~74세,32099,31906,193
2025-02-28,16,본인,75~79세,121028,120807,221
2025-02-28,17,본인,80~84세,48005,47845,160
2025-02-28,18,본인,85~89세,11096,10783,313
2025-02-28,19,본인,90~94세,24662,24056,606
2025-02-28,20,본인,95~99세,6605,6499,106
2025-02-28,21,본인,100세이상,433,424,9
2025-02-28,22,본인,해당없음,0,0,0
2025-02-28,23,유족,0~4세,0,0,0
2025-02-28,24,유족,5~9세,5,2,3
2025-02-28,25,유족,10~14세,14,9,5
2025-02-28,26,유족,15~19세,31,23,8
2025-02-28,27,유족,20~24세,83,45,38
2025-02-28,28,유족,25~29세,113,69,44
2025-02-28,29,유족,30~34세,326,186,140
2025-02-28,30,유족,35~39세,560,313,247
2025-02-28,31,유족,40~44세,1666,956,710
2025-02-28,32,유족,45~49세,4035,2497,1538
2025-02-28,33,유족,50~54세,8648,5526,3122
2025-02-28,34,유족,55~59세,13743,9094,4649
2025-02-28,35,유족,60~64세,25596,16674,8922
2025-02-28,36,유족,65~69세,45722,26531,19191
2025-02-28,37,유족,70~74세,49147,20055,29092
2025-02-28,38,유족,75~79세,40909,13521,27388
2025-02-28,39,유족,80~84세,22197,4251,17946
2025-02-28,40,유족,85~89세,31279,1910,29369
2025-02-28,41,유족,90~94세,21220,590,20630
2025-02-28,42,유족,95~99세,3759,105,3654
2025-02-28,43,유족,100세이상,480,61,419
2025-02-28,44,유족,해당없음,0,0,0
2025-01-31,1,본인,0~4세,0,0,0
2025-01-31,2,본인,5~9세,0,0,0
2025-01-31,3,본인,10~14세,0,0,0
2025-01-31,4,본인,15~19세,0,0,0
2025-01-31,5,본인,20~24세,405,390,15
2025-01-31,6,본인,25~29세,6399,6112,287
2025-01-31,7,본인,30~34세,15223,14328,895
2025-01-31,8,본인,35~39세,14425,13495,930
2025-01-31,9,본인,40~44세,14979,14255,724
2025-01-31,10,본인,45~49세,15420,14721,699
2025-01-31,11,본인,50~54세,16177,15834,343
2025-01-31,12,본인,55~59세,20209,19826,383
2025-01-31,13,본인,60~64세,22842,22319,523
2025-01-31,14,본인,65~69세,24712,24302,410
2025-01-31,15,본인,70~74세,32713,32528,185
2025-01-31,16,본인,75~79세,122283,122063,220
2025-01-31,17,본인,80~84세,46539,46376,163
2025-01-31,18,본인,85~89세,11142,10812,330
2025-01-31,19,본인,90~94세,25264,24668,596
2025-01-31,20,본인,95~99세,6504,6403,101
2025-01-31,21,본인,100세이상,420,411,9
2025-01-31,22,본인,해당없음,0,0,0
2025-01-31,23,유족,0~4세,0,0,0
2025-01-31,24,유족,5~9세,4,2,2
2025-01-31,25,유족,10~14세,14,9,5
2025-01-31,26,유족,15~19세,31,23,8
2025-01-31,27,유족,20~24세,83,43,40
2025-01-31,28,유족,25~29세,113,70,43
2025-01-31,29,유족,30~34세,334,187,147
2025-01-31,30,유족,35~39세,553,315,238
2025-01-31,31,유족,40~44세,1695,976,719
2025-01-31,32,유족,45~49세,4064,2518,1546
2025-01-31,33,유족,50~54세,8604,5508,3096
2025-01-31,34,유족,55~59세,13760,9107,4653
2025-01-31,35,유족,60~64세,25762,16745,9017
2025-01-31,36,유족,65~69세,45637,26415,19222
2025-01-31,37,유족,70~74세,48894,19867,29027
2025-01-31,38,유족,75~79세,40181,13279,26902
2025-01-31,39,유족,80~84세,22261,4206,18055
2025-01-31,40,유족,85~89세,31692,1891,29801
2025-01-31,41,유족,90~94세,20917,582,20335
2025-01-31,42,유족,95~99세,3713,110,3603
2025-01-31,43,유족,100세이상,470,61,409
2025-01-31,44,유족,해당없음,0,0,0
2024-12-31,1,본인,0~4세,0,0,0
2024-12-31,2,본인,5~9세,0,0,0
2024-12-31,3,본인,10~14세,0,0,0
2024-12-31,4,본인,15~19세,0,0,0
2024-12-31,5,본인,20~24세,402,387,15
2024-12-31,6,본인,25~29세,6484,6196,288
2024-12-31,7,본인,30~34세,15206,14306,900
2024-12-31,8,본인,35~39세,14325,13392,933
2024-12-31,9,본인,40~44세,14969,14257,712
2024-12-31,10,본인,45~49세,15267,14589,678
2024-12-31,11,본인,50~54세,16011,15667,344
2024-12-31,12,본인,55~59세,20178,19798,380
2024-12-31,13,본인,60~64세,22879,22356,523
2024-12-31,14,본인,65~69세,24814,24407,407
2024-12-31,15,본인,70~74세,33513,33336,177
2024-12-31,16,본인,75~79세,123503,123285,218
2024-12-31,17,본인,80~84세,44879,44710,169
2024-12-31,18,본인,85~89세,11236,10897,339
2024-12-31,19,본인,90~94세,25782,25182,600
2024-12-31,20,본인,95~99세,6315,6221,94
2024-12-31,21,본인,100세이상,398,389,9
2024-12-31,22,본인,해당없음,0,0,0
2024-12-31,23,유족,0~4세,0,0,0
2024-12-31,24,유족,5~9세,6,4,2
2024-12-31,25,유족,10~14세,14,9,5
2024-12-31,26,유족,15~19세,29,21,8
2024-12-31,27,유족,20~24세,86,45,41
2024-12-31,28,유족,25~29세,113,71,42
2024-12-31,29,유족,30~34세,335,187,148
2024-12-31,30,유족,35~39세,564,322,242
2024-12-31,31,유족,40~44세,1726,1004,722
2024-12-31,32,유족,45~49세,4115,2549,1566
2024-12-31,33,유족,50~54세,8608,5527,3081
2024-12-31,34,유족,55~59세,13740,9098,4642
2024-12-31,35,유족,60~64세,25964,16850,9114
2024-12-31,36,유족,65~69세,45800,26406,19394
2024-12-31,37,유족,70~74세,48719,19731,28988
2024-12-31,38,유족,75~79세,39399,12951,26448
2024-12-31,39,유족,80~84세,22277,4168,18109
2024-12-31,40,유족,85~89세,32096,1877,30219
2024-12-31,41,유족,90~94세,20525,581,19944
2024-12-31,42,유족,95~99세,3585,101,3484
2024-12-31,43,유족,100세이상,470,60,410
2024-12-31,44,유족,해당없음,0,0,0
2024-11-30,1,본인,0~4세,0,0,0
2024-11-30,2,본인,5~9세,0,0,0
2024-11-30,3,본인,10~14세,0,0,0
2024-11-30,4,본인,15~19세,0,0,0
2024-11-30,5,본인,20~24세,399,385,14
2024-11-30,6,본인,25~29세,6473,6193,280
2024-11-30,7,본인,30~34세,15099,14192,907
2024-11-30,8,본인,35~39세,14283,13368,915
2024-11-30,9,본인,40~44세,15035,14318,717
2024-11-30,10,본인,45~49세,15227,14557,670
2024-11-30,11,본인,50~54세,15840,15502,338
2024-11-30,12,본인,55~59세,20247,19874,373
2024-11-30,13,본인,60~64세,22906,22373,533
2024-11-30,14,본인,65~69세,24863,24465,398
2024-11-30,15,본인,70~74세,34606,34425,181
2024-11-30,16,본인,75~79세,123635,123419,216
2024-11-30,17,본인,80~84세,43912,43745,167
2024-11-30,18,본인,85~89세,11410,11056,354
2024-11-30,19,본인,90~94세,26247,25652,595
2024-11-30,20,본인,95~99세,6150,6056,94
2024-11-30,21,본인,100세이상,383,376,7
2024-11-30,22,본인,해당없음,0,0,0
2024-11-30,23,유족,0~4세,0,0,0
2024-11-30,24,유족,5~9세,6,4,2
2024-11-30,25,유족,10~14세,14,9,5
2024-11-30,26,유족,15~19세,28,20,8
2024-11-30,27,유족,20~24세,87,45,42
2024-11-30,28,유족,25~29세,117,72,45
2024-11-30,29,유족,30~34세,332,187,145
2024-11-30,30,유족,35~39세,583,332,251
2024-11-30,31,유족,40~44세,1742,1008,734
2024-11-30,32,유족,45~49세,4109,2553,1556
2024-11-30,33,유족,50~54세,8610,5537,3073
2024-11-30,34,유족,55~59세,13776,9122,4654
2024-11-30,35,유족,60~64세,26113,16921,9192
2024-11-30,36,유족,65~69세,45563,26206,19357
2024-11-30,37,유족,70~74세,48634,19651,28983
2024-11-30,38,유족,75~79세,38727,12714,26013
2024-11-30,39,유족,80~84세,22394,4132,18262
2024-11-30,40,유족,85~89세,32480,1868,30612
2024-11-30,41,유족,90~94세,20201,582,19619
2024-11-30,42,유족,95~99세,3481,101,3380
2024-11-30,43,유족,100세이상,469,61,408
2024-11-30,44,유족,해당없음,2,0,2
2024-10-31,1,본인,0~4세,0,0,0
2024-10-31,2,본인,5~9세,0,0,0
2024-10-31,3,본인,10~14세,0,0,0
2024-10-31,4,본인,15~19세,0,0,0
2024-10-31,5,본인,20~24세,426,410,16
2024-10-31,6,본인,25~29세,6545,6262,283
2024-10-31,7,본인,30~34세,15030,14120,910
2024-10-31,8,본인,35~39세,14197,13285,912
2024-10-31,9,본인,40~44세,15069,14353,716
2024-10-31,10,본인,45~49세,15149,14486,663
2024-10-31,11,본인,50~54세,15755,15425,330
2024-10-31,12,본인,55~59세,20224,19852,372
2024-10-31,13,본인,60~64세,22932,22395,537
2024-10-31,14,본인,65~69세,24931,24543,388
2024-10-31,15,본인,70~74세,35497,35313,184
2024-10-31,16,본인,75~79세,124008,123796,212
2024-10-31,17,본인,80~84세,42899,42729,170
2024-10-31,18,본인,85~89세,11522,11162,360
2024-10-31,19,본인,90~94세,26682,26082,600
2024-10-31,20,본인,95~99세,6053,5965,88
2024-10-31,21,본인,100세이상,377,369,8
2024-10-31,22,본인,해당없음,0,0,0
2024-10-31,23,유족,0~4세,0,0,0
2024-10-31,24,유족,5~9세,6,4,2
2024-10-31,25,유족,10~14세,15,10,5
2024-10-31,26,유족,15~19세,28,19,9
2024-10-31,27,유족,20~24세,86,45,41
2024-10-31,28,유족,25~29세,116,70,46
2024-10-31,29,유족,30~34세,336,189,147
2024-10-31,30,유족,35~39세,585,331,254
2024-10-31,31,유족,40~44세,1749,1013,736
2024-10-31,32,유족,45~49세,4117,2560,1557
2024-10-31,33,유족,50~54세,8622,5555,3067
2024-10-31,34,유족,55~59세,13788,9152,4636
2024-10-31,35,유족,60~64세,26231,17010,9221
2024-10-31,36,유족,65~69세,45443,26040,19403
2024-10-31,37,유족,70~74세,48469,19546,28923
2024-10-31,38,유족,75~79세,38123,12491,25632
2024-10-31,39,유족,80~84세,22463,4108,18355
2024-10-31,40,유족,85~89세,32742,1842,30900
2024-10-31,41,유족,90~94세,19992,575,19417
2024-10-31,42,유족,95~99세,3419,99,3320
2024-10-31,43,유족,100세이상,467,61,406
2024-10-31,44,유족,해당없음,1,0,1
2024-09-30,1,본인,0~4세,0,0,0
2024-09-30,2,본인,5~9세,0,0,0
2024-09-30,3,본인,10~14세,0,0,0
2024-09-30,4,본인,15~19세,0,0,0
2024-09-30,5,본인,20~24세,432,417,15
2024-09-30,6,본인,25~29세,6545,6256,289
2024-09-30,7,본인,30~34세,14988,14072,916
2024-09-30,8,본인,35~39세,14182,13281,901
2024-09-30,9,본인,40~44세,15023,14307,716
2024-09-30,10,본인,45~49세,15119,14464,655
2024-09-30,11,본인,50~54세,15608,15285,323
2024-09-30,12,본인,55~59세,20216,19858,358
2024-09-30,13,본인,60~64세,23003,22457,546
2024-09-30,14,본인,65~69세,24976,24596,380
2024-09-30,15,본인,70~74세,36482,36298,184
2024-09-30,16,본인,75~79세,124434,124223,211
2024-09-30,17,본인,80~84세,41782,41613,169
2024-09-30,18,본인,85~89세,11650,11276,374
2024-09-30,19,본인,90~94세,27206,26609,597
2024-09-30,20,본인,95~99세,6001,5915,86
2024-09-30,21,본인,100세이상,380,371,9
2024-09-30,22,본인,해당없음,0,0,0
2024-09-30,23,유족,0~4세,0,0,0
2024-09-30,24,유족,5~9세,6,4,2
2024-09-30,25,유족,10~14세,15,10,5
2024-09-30,26,유족,15~19세,29,20,9
2024-09-30,27,유족,20~24세,84,42,42
2024-09-30,28,유족,25~29세,117,70,47
2024-09-30,29,유족,30~34세,335,190,145
2024-09-30,30,유족,35~39세,595,339,256
2024-09-30,31,유족,40~44세,1760,1013,747
2024-09-30,32,유족,45~49세,4114,2570,1544
2024-09-30,33,유족,50~54세,8642,5557,3085
2024-09-30,34,유족,55~59세,13817,9192,4625
2024-09-30,35,유족,60~64세,26389,17075,9314
2024-09-30,36,유족,65~69세,45268,25850,19418
2024-09-30,37,유족,70~74세,48365,19483,28882
2024-09-30,38,유족,75~79세,37492,12246,25246
2024-09-30,39,유족,80~84세,22474,4065,18409
2024-09-30,40,유족,85~89세,33008,1840,31168
2024-09-30,41,유족,90~94세,19773,569,19204
2024-09-30,42,유족,95~99세,3376,95,3281
2024-09-30,43,유족,100세이상,465,61,404
2024-09-30,44,유족,해당없음,1,0,1
2024-08-31,1,본인,0~4세,0,0,0
2024-08-31,2,본인,5~9세,0,0,0
2024-08-31,3,본인,10~14세,0,0,0
2024-08-31,4,본인,15~19세,0,0,0
2024-08-31,5,본인,20~24세,439,425,14
2024-08-31,6,본인,25~29세,6444,6154,290
2024-08-31,7,본인,30~34세,14947,14034,913
2024-08-31,8,본인,35~39세,14111,13226,885
2024-08-31,9,본인,40~44세,15042,14331,711
2024-08-31,10,본인,45~49세,15070,14416,654
2024-08-31,11,본인,50~54세,15511,15197,314
2024-08-31,12,본인,55~59세,20198,19848,350
2024-08-31,13,본인,60~64세,23062,22512,550
2024-08-31,14,본인,65~69세,25077,24705,372
2024-08-31,15,본인,70~74세,37451,37263,188
2024-08-31,16,본인,75~79세,124985,124776,209
2024-08-31,17,본인,80~84세,40497,40327,170
2024-08-31,18,본인,85~89세,11791,11403,388
2024-08-31,19,본인,90~94세,27617,27027,590
2024-08-31,20,본인,95~99세,5977,5892,85
2024-08-31,21,본인,100세이상,371,362,9
2024-08-31,22,본인,해당없음,0,0,0
2024-08-31,23,유족,0~4세,0,0,0
2024-08-31,24,유족,5~9세,6,4,2
2024-08-31,25,유족,10~14세,15,10,5
2024-08-31,26,유족,15~19세,30,20,10
2024-08-31,27,유족,20~24세,85,44,41
2024-08-31,28,유족,25~29세,119,71,48
2024-08-31,29,유족,30~34세,337,189,148
2024-08-31,30,유족,35~39세,593,341,252
2024-08-31,31,유족,40~44세,1773,1024,749
2024-08-31,32,유족,45~49세,4130,2570,1560
2024-08-31,33,유족,50~54세,8674,5592,3082
2024-08-31,34,유족,55~59세,13874,9244,4630
2024-08-31,35,유족,60~64세,26495,17114,9381
2024-08-31,36,유족,65~69세,45129,25720,19409
2024-08-31,37,유족,70~74세,48384,19444,28940
2024-08-31,38,유족,75~79세,36859,12003,24856
2024-08-31,39,유족,80~84세,22453,4013,18440
2024-08-31,40,유족,85~89세,33243,1820,31423
2024-08-31,41,유족,90~94세,19546,562,18984
2024-08-31,42,유족,95~99세,3293,95,3198
2024-08-31,43,유족,100세이상,464,62,402
2024-08-31,44,유족,해당없음,1,0,1
2024-07-31,1,본인,0~4세,0,0,0
2024-07-31,2,본인,5~9세,0,0,0
2024-07-31,3,본인,10~14세,0,0,0
2024-07-31,4,본인,15~19세,0,0,0
2024-07-31,5,본인,20~24세,450,436,14
2024-07-31,6,본인,25~29세,6513,6216,297
2024-07-31,7,본인,30~34세,14825,13916,909
2024-07-31,8,본인,35~39세,14087,13204,883
2024-07-31,9,본인,40~44세,14973,14269,704
2024-07-31,10,본인,45~49세,15033,14389,644
2024-07-31,11,본인,50~54세,15458,15144,314
2024-07-31,12,본인,55~59세,20178,19836,342
2024-07-31,13,본인,60~64세,23092,22545,547
2024-07-31,14,본인,65~69세,25142,24773,369
2024-07-31,15,본인,70~74세,38597,38408,189
2024-07-31,16,본인,75~79세,125362,125159,203
2024-07-31,17,본인,80~84세,39174,38999,175
2024-07-31,18,본인,85~89세,11972,11579,393
2024-07-31,19,본인,90~94세,28011,27424,587
2024-07-31,20,본인,95~99세,5829,5744,85
2024-07-31,21,본인,100세이상,364,355,9
2024-07-31,22,본인,해당없음,0,0,0
2024-07-31,23,유족,0~4세,0,0,0
2024-07-31,24,유족,5~9세,7,4,3
2024-07-31,25,유족,10~14세,15,11,4
2024-07-31,26,유족,15~19세,30,20,10
2024-07-31,27,유족,20~24세,84,44,40
2024-07-31,28,유족,25~29세,122,72,50
2024-07-31,29,유족,30~34세,337,189,148
2024-07-31,30,유족,35~39세,598,345,253
2024-07-31,31,유족,40~44세,1800,1037,763
2024-07-31,32,유족,45~49세,4145,2585,1560
2024-07-31,33,유족,50~54세,8680,5597,3083
2024-07-31,34,유족,55~59세,13902,9269,4633
2024-07-31,35,유족,60~64세,26711,17264,9447
2024-07-31,36,유족,65~69세,44913,25474,19439
2024-07-31,37,유족,70~74세,48341,19412,28929
2024-07-31,38,유족,75~79세,36283,11742,24541
2024-07-31,39,유족,80~84세,22456,3961,18495
2024-07-31,40,유족,85~89세,33545,1820,31725
2024-07-31,41,유족,90~94세,19290,550,18740
2024-07-31,42,유족,95~99세,3233,91,3142
2024-07-31,43,유족,100세이상,461,61,400
2024-07-31,44,유족,해당없음,1,0,1
2024-06-30,1,본인,0~4세,0,0,0
2024-06-30,2,본인,5~9세,0,0,0
2024-06-30,3,본인,10~14세,0,0,0
2024-06-30,4,본인,15~19세,0,0,0
2024-06-30,5,본인,20~24세,448,433,15
2024-06-30,6,본인,25~29세,6311,6027,284
2024-06-30,7,본인,30~34세,14571,13675,896
2024-06-30,8,본인,35~39세,14061,13183,878
2024-06-30,9,본인,40~44세,14926,14220,706
2024-06-30,10,본인,45~49세,14984,14356,628
2024-06-30,11,본인,50~54세,15215,14906,309
2024-06-30,12,본인,55~59세,20161,19820,341
2024-06-30,13,본인,60~64세,22968,22439,529
2024-06-30,14,본인,65~69세,25278,24913,365
2024-06-30,15,본인,70~74세,39918,39729,189
2024-06-30,16,본인,75~79세,125374,125175,199
2024-06-30,17,본인,80~84세,38068,37891,177
2024-06-30,18,본인,85~89세,12150,11747,403
2024-06-30,19,본인,90~94세,28476,27889,587
2024-06-30,20,본인,95~99세,5791,5706,85
2024-06-30,21,본인,100세이상,362,354,8
2024-06-30,22,본인,해당없음,0,0,0
2024-06-30,23,유족,0~4세,0,0,0
2024-06-30,24,유족,5~9세,7,4,3
2024-06-30,25,유족,10~14세,15,11,4
2024-06-30,26,유족,15~19세,30,20,10
2024-06-30,27,유족,20~24세,87,46,41
2024-06-30,28,유족,25~29세,117,68,49
2024-06-30,29,유족,30~34세,336,188,148
2024-06-30,30,유족,35~39세,607,351,256
2024-06-30,31,유족,40~44세,1818,1055,763
2024-06-30,32,유족,45~49세,4146,2589,1557
2024-06-30,33,유족,50~54세,8689,5604,3085
2024-06-30,34,유족,55~59세,13905,9287,4618
2024-06-30,35,유족,60~64세,26777,17319,9458
2024-06-30,36,유족,65~69세,44726,25251,19475
2024-06-30,37,유족,70~74세,48480,19428,29052
2024-06-30,38,유족,75~79세,35424,11435,23989
2024-06-30,39,유족,80~84세,22529,3924,18605
2024-06-30,40,유족,85~89세,33764,1828,31936
2024-06-30,41,유족,90~94세,19183,541,18642
2024-06-30,42,유족,95~99세,3183,93,3090
2024-06-30,43,유족,100세이상,453,60,393
2024-06-30,44,유족,해당없음,1,0,1
2024-05-31,1,본인,0~4세,0,0,0
2024-05-31,2,본인,5~9세,0,0,0
2024-05-31,3,본인,10~14세,0,0,0
2024-05-31,4,본인,15~19세,0,0,0
2024-05-31,5,본인,20~24세,414,407,7
2024-05-31,6,본인,25~29세,6120,5855,265
2024-05-31,7,본인,30~34세,14452,13576,876
2024-05-31,8,본인,35~39세,14032,13158,874
2024-05-31,9,본인,40~44세,14892,14195,697
2024-05-31,10,본인,45~49세,14970,14346,624
2024-05-31,11,본인,50~54세,15096,14784,312
2024-05-31,12,본인,55~59세,20107,19771,336
2024-05-31,13,본인,60~64세,22987,22461,526
2024-05-31,14,본인,65~69세,25443,25077,366
2024-05-31,15,본인,70~74세,40733,40542,191
2024-05-31,16,본인,75~79세,125626,125430,196
2024-05-31,17,본인,80~84세,37094,36918,176
2024-05-31,18,본인,85~89세,12323,11905,418
2024-05-31,19,본인,90~94세,28927,28341,586
2024-05-31,20,본인,95~99세,5782,5697,85
2024-05-31,21,본인,100세이상,362,354,8
2024-05-31,22,본인,해당없음,0,0,0
2024-05-31,23,유족,0~4세,0,0,0
2024-05-31,24,유족,5~9세,7,4,3
2024-05-31,25,유족,10~14세,15,11,4
2024-05-31,26,유족,15~19세,30,20,10
2024-05-31,27,유족,20~24세,88,47,41
2024-05-31,28,유족,25~29세,117,69,48
2024-05-31,29,유족,30~34세,339,189,150
2024-05-31,30,유족,35~39세,605,350,255
2024-05-31,31,유족,40~44세,1833,1063,770
2024-05-31,32,유족,45~49세,4177,2618,1559
2024-05-31,33,유족,50~54세,8686,5603,3083
2024-05-31,34,유족,55~59세,13894,9288,4606
2024-05-31,35,유족,60~64세,26786,17318,9468
2024-05-31,36,유족,65~69세,44681,25140,19541
2024-05-31,37,유족,70~74세,48365,19316,29049
2024-05-31,38,유족,75~79세,34933,11253,23680
2024-05-31,39,유족,80~84세,22556,3880,18676
2024-05-31,40,유족,85~89세,33941,1813,32128
2024-05-31,41,유족,90~94세,19096,538,18558
2024-05-31,42,유족,95~99세,3162,94,3068
2024-05-31,43,유족,100세이상,456,61,395
2024-05-31,44,유족,해당없음,1,0,1
2024-04-30,1,본인,0~4세,0,0,0
2024-04-30,2,본인,5~9세,0,0,0
2024-04-30,3,본인,10~14세,0,0,0
2024-04-30,4,본인,15~19세,0,0,0
2024-04-30,5,본인,20~24세,412,407,5
2024-04-30,6,본인,25~29세,6130,5858,272
2024-04-30,7,본인,30~34세,14364,13501,863
2024-04-30,8,본인,35~39세,13988,13124,864
2024-04-30,9,본인,40~44세,14873,14177,696
2024-04-30,10,본인,45~49세,14971,14356,615
2024-04-30,11,본인,50~54세,14969,14661,308
2024-04-30,12,본인,55~59세,20057,19721,336
2024-04-30,13,본인,60~64세,23038,22515,523
2024-04-30,14,본인,65~69세,25498,25136,362
2024-04-30,15,본인,70~74세,41719,41527,192
2024-04-30,16,본인,75~79세,125962,125768,194
2024-04-30,17,본인,80~84세,35986,35807,179
2024-04-30,18,본인,85~89세,12512,12078,434
2024-04-30,19,본인,90~94세,29338,28761,577
2024-04-30,20,본인,95~99세,5674,5589,85
2024-04-30,21,본인,100세이상,351,343,8
2024-04-30,22,본인,해당없음,0,0,0
2024-04-30,23,유족,0~4세,0,0,0
2024-04-30,24,유족,5~9세,7,4,3
2024-04-30,25,유족,10~14세,15,11,4
2024-04-30,26,유족,15~19세,34,21,13
2024-04-30,27,유족,20~24세,83,46,37
2024-04-30,28,유족,25~29세,126,71,55
2024-04-30,29,유족,30~34세,333,187,146
2024-04-30,30,유족,35~39세,608,349,259
2024-04-30,31,유족,40~44세,1848,1076,772
2024-04-30,32,유족,45~49세,4207,2642,1565
2024-04-30,33,유족,50~54세,8679,5595,3084
2024-04-30,34,유족,55~59세,13920,9317,4603
2024-04-30,35,유족,60~64세,26910,17382,9528
2024-04-30,36,유족,65~69세,44493,24945,19548
2024-04-30,37,유족,70~74세,48262,19214,29048
2024-04-30,38,유족,75~79세,34355,11057,23298
2024-04-30,39,유족,80~84세,22723,3869,18854
2024-04-30,40,유족,85~89세,34136,1800,32336
2024-04-30,41,유족,90~94세,18879,531,18348
2024-04-30,42,유족,95~99세,3097,94,3003
2024-04-30,43,유족,100세이상,451,60,391
2024-04-30,44,유족,해당없음,1,0,1
2024-03-31,1,본인,0~4세,0,0,0
2024-03-31,2,본인,5~9세,0,0,0
2024-03-31,3,본인,10~14세,0,0,0
2024-03-31,4,본인,15~19세,0,0,0
2024-03-31,5,본인,20~24세,404,399,5
2024-03-31,6,본인,25~29세,6133,5859,274
2024-03-31,7,본인,30~34세,14277,13424,853
2024-03-31,8,본인,35~39세,13956,13096,860
2024-03-31,9,본인,40~44세,14794,14096,698
2024-03-31,10,본인,45~49세,15027,14415,612
2024-03-31,11,본인,50~54세,14790,14485,305
2024-03-31,12,본인,55~59세,19991,19658,333
2024-03-31,13,본인,60~64세,23087,22564,523
2024-03-31,14,본인,65~69세,25492,25132,360
2024-03-31,15,본인,70~74세,42784,42600,184
2024-03-31,16,본인,75~79세,126847,126654,193
2024-03-31,17,본인,80~84세,34405,34223,182
2024-03-31,18,본인,85~89세,12736,12290,446
2024-03-31,19,본인,90~94세,29808,29231,577
2024-03-31,20,본인,95~99세,5557,5480,77
2024-03-31,21,본인,100세이상,333,325,8
2024-03-31,22,본인,해당없음,0,0,0
2024-03-31,23,유족,0~4세,0,0,0
2024-03-31,24,유족,5~9세,7,4,3
2024-03-31,25,유족,10~14세,14,10,4
2024-03-31,26,유족,15~19세,33,20,13
2024-03-31,27,유족,20~24세,83,45,38
2024-03-31,28,유족,25~29세,132,77,55
2024-03-31,29,유족,30~34세,327,181,146
2024-03-31,30,유족,35~39세,614,353,261
2024-03-31,31,유족,40~44세,1837,1073,764
2024-03-31,32,유족,45~49세,4241,2661,1580
2024-03-31,33,유족,50~54세,8683,5598,3085
2024-03-31,34,유족,55~59세,13901,9292,4609
2024-03-31,35,유족,60~64세,26900,17334,9566
2024-03-31,36,유족,65~69세,44200,24728,19472
2024-03-31,37,유족,70~74세,48143,19105,29038
2024-03-31,38,유족,75~79세,33910,10918,22992
2024-03-31,39,유족,80~84세,22832,3844,18988
2024-03-31,40,유족,85~89세,34351,1773,32578
2024-03-31,41,유족,90~94세,18746,528,18218
2024-03-31,42,유족,95~99세,3031,92,2939
2024-03-31,43,유족,100세이상,448,58,390
2024-03-31,44,유족,해당없음,1,0,1
2024-02-29,1,본인,0~4세,0,0,0
2024-02-29,2,본인,5~9세,0,0,0
2024-02-29,3,본인,10~14세,0,0,0
2024-02-29,4,본인,15~19세,0,0,0
2024-02-29,5,본인,20~24세,396,389,7
2024-02-29,6,본인,25~29세,5935,5707,228
2024-02-29,7,본인,30~34세,14146,13303,843
2024-02-29,8,본인,35~39세,13904,13053,851
2024-02-29,9,본인,40~44세,14759,14062,697
2024-02-29,10,본인,45~49세,15061,14454,607
2024-02-29,11,본인,50~54세,14697,14397,300
2024-02-29,12,본인,55~59세,19947,19616,331
2024-02-29,13,본인,60~64세,23136,22607,529
2024-02-29,14,본인,65~69세,25467,25118,349
2024-02-29,15,본인,70~74세,44103,43918,185
2024-02-29,16,본인,75~79세,127080,126889,191
2024-02-29,17,본인,80~84세,33146,32957,189
2024-02-29,18,본인,85~89세,13011,12541,470
2024-02-29,19,본인,90~94세,30284,29714,570
2024-02-29,20,본인,95~99세,5433,5364,69
2024-02-29,21,본인,100세이상,323,315,8
2024-02-29,22,본인,해당없음,0,0,0
2024-02-29,23,유족,0~4세,0,0,0
2024-02-29,24,유족,5~9세,7,4,3
2024-02-29,25,유족,10~14세,14,10,4
2024-02-29,26,유족,15~19세,34,21,13
2024-02-29,27,유족,20~24세,81,43,38
2024-02-29,28,유족,25~29세,133,77,56
2024-02-29,29,유족,30~34세,332,186,146
2024-02-29,30,유족,35~39세,620,359,261
2024-02-29,31,유족,40~44세,1837,1075,762
2024-02-29,32,유족,45~49세,4279,2700,1579
2024-02-29,33,유족,50~54세,8680,5594,3086
2024-02-29,34,유족,55~59세,13942,9321,4621
2024-02-29,35,유족,60~64세,27042,17389,9653
2024-02-29,36,유족,65~69세,43908,24444,19464
2024-02-29,37,유족,70~74세,48122,19028,29094
2024-02-29,38,유족,75~79세,33314,10725,22589
2024-02-29,39,유족,80~84세,23001,3790,19211
2024-02-29,40,유족,85~89세,34581,1762,32819
2024-02-29,41,유족,90~94세,18402,519,17883
2024-02-29,42,유족,95~99세,2943,94,2849
2024-02-29,43,유족,100세이상,442,57,385
2024-02-29,44,유족,해당없음,1,0,1
2024-01-31,1,본인,0~4세,0,0,0
2024-01-31,2,본인,5~9세,0,0,0
2024-01-31,3,본인,10~14세,0,0,0
2024-01-31,4,본인,15~19세,0,0,0
2024-01-31,5,본인,20~24세,414,405,9
2024-01-31,6,본인,25~29세,6035,5800,235
2024-01-31,7,본인,30~34세,14164,13322,842
2024-01-31,8,본인,35~39세,13883,13041,842
2024-01-31,9,본인,40~44세,14663,13964,699
2024-01-31,10,본인,45~49세,15012,14421,591
2024-01-31,11,본인,50~54세,14609,14316,293
2024-01-31,12,본인,55~59세,19930,19597,333
2024-01-31,13,본인,60~64세,23160,22631,529
2024-01-31,14,본인,65~69세,25449,25112,337
2024-01-31,15,본인,70~74세,45475,45289,186
2024-01-31,16,본인,75~79세,127308,127119,189
2024-01-31,17,본인,80~84세,31914,31722,192
2024-01-31,18,본인,85~89세,13260,12780,480
2024-01-31,19,본인,90~94세,30812,30245,567
2024-01-31,20,본인,95~99세,5336,5268,68
2024-01-31,21,본인,100세이상,314,306,8
2024-01-31,22,본인,해당없음,0,0,0
2024-01-31,23,유족,0~4세,0,0,0
2024-01-31,24,유족,5~9세,6,3,3
2024-01-31,25,유족,10~14세,15,11,4
2024-01-31,26,유족,15~19세,34,20,14
2024-01-31,27,유족,20~24세,81,44,37
2024-01-31,28,유족,25~29세,135,78,57
2024-01-31,29,유족,30~34세,332,186,146
2024-01-31,30,유족,35~39세,620,357,263
2024-01-31,31,유족,40~44세,1874,1097,777
2024-01-31,32,유족,45~49세,4285,2702,1583
2024-01-31,33,유족,50~54세,8707,5629,3078
2024-01-31,34,유족,55~59세,14029,9381,4648
2024-01-31,35,유족,60~64세,27074,17407,9667
2024-01-31,36,유족,65~69세,43666,24205,19461
2024-01-31,37,유족,70~74세,48247,19027,29220
2024-01-31,38,유족,75~79세,32667,10517,22150
2024-01-31,39,유족,80~84세,23157,3736,19421
2024-01-31,40,유족,85~89세,34737,1739,32998
2024-01-31,41,유족,90~94세,18094,518,17576
2024-01-31,42,유족,95~99세,2869,94,2775
2024-01-31,43,유족,100세이상,436,57,379
2024-01-31,44,유족,해당없음,2,0,2
2023-12-31,1,본인,0~4세,0,0,0
2023-12-31,2,본인,5~9세,0,0,0
2023-12-31,3,본인,10~14세,0,0,0
2023-12-31,4,본인,15~19세,0,0,0
2023-12-31,5,본인,20~24세,386,378,8
2023-12-31,6,본인,25~29세,6026,5785,241
2023-12-31,7,본인,30~34세,14071,13238,833
2023-12-31,8,본인,35~39세,13815,12986,829
2023-12-31,9,본인,40~44세,14569,13863,706
2023-12-31,10,본인,45~49세,14881,14325,556
2023-12-31,11,본인,50~54세,14407,14113,294
2023-12-31,12,본인,55~59세,19712,19391,321
2023-12-31,13,본인,60~64세,23326,22783,543
2023-12-31,14,본인,65~69세,25404,25091,313
2023-12-31,15,본인,70~74세,49242,49052,190
2023-12-31,16,본인,75~79세,126236,126053,183
2023-12-31,17,본인,80~84세,29855,29662,193
2023-12-31,18,본인,85~89세,13977,13467,510
2023-12-31,19,본인,90~94세,31670,31108,562
2023-12-31,20,본인,95~99세,5046,4992,54
2023-12-31,21,본인,100세이상,292,285,7
2023-12-31,22,본인,해당없음,0,0,0
2023-12-31,23,유족,0~4세,0,0,0
2023-12-31,24,유족,5~9세,6,3,3
2023-12-31,25,유족,10~14세,16,12,4
2023-12-31,26,유족,15~19세,34,20,14
2023-12-31,27,유족,20~24세,80,43,37
2023-12-31,28,유족,25~29세,143,83,60
2023-12-31,29,유족,30~34세,332,188,144
2023-12-31,30,유족,35~39세,638,364,274
2023-12-31,31,유족,40~44세,1895,1112,783
2023-12-31,32,유족,45~49세,4359,2758,1601
2023-12-31,33,유족,50~54세,8746,5652,3094
2023-12-31,34,유족,55~59세,13915,9320,4595
2023-12-31,35,유족,60~64세,27520,17669,9851
2023-12-31,36,유족,65~69세,43017,23625,19392
2023-12-31,37,유족,70~74세,48358,19001,29357
2023-12-31,38,유족,75~79세,31395,10049,21346
2023-12-31,39,유족,80~84세,23520,3657,19863
2023-12-31,40,유족,85~89세,35079,1678,33401
2023-12-31,41,유족,90~94세,17456,495,16961
2023-12-31,42,유족,95~99세,2714,104,2610
2023-12-31,43,유족,100세이상,421,52,369
2023-12-31,44,유족,해당없음,2,0,2
2023-11-30,1,본인,0~4세,0,0,0
2023-11-30,2,본인,5~9세,0,0,0
2023-11-30,3,본인,10~14세,0,0,0
2023-11-30,4,본인,15~19세,0,0,0
2023-11-30,5,본인,20~24세,386,378,8
2023-11-30,6,본인,25~29세,6026,5785,241
2023-11-30,7,본인,30~34세,14071,13238,833
2023-11-30,8,본인,35~39세,13815,12986,829
2023-11-30,9,본인,40~44세,14569,13863,706
2023-11-30,10,본인,45~49세,14881,14325,556
2023-11-30,11,본인,50~54세,14407,14113,294
2023-11-30,12,본인,55~59세,19712,19391,321
2023-11-30,13,본인,60~64세,23326,22783,543
2023-11-30,14,본인,65~69세,25404,25091,313
2023-11-30,15,본인,70~74세,49242,49052,190
2023-11-30,16,본인,75~79세,126236,126053,183
2023-11-30,17,본인,80~84세,29855,29662,193
2023-11-30,18,본인,85~89세,13977,13467,510
2023-11-30,19,본인,90~94세,31670,31108,562
2023-11-30,20,본인,95~99세,5046,4992,54
2023-11-30,21,본인,100세이상,292,285,7
2023-11-30,22,본인,해당없음,0,0,0
2023-11-30,23,유족,0~4세,0,0,0
2023-11-30,24,유족,5~9세,6,3,3
2023-11-30,25,유족,10~14세,16,12,4
2023-11-30,26,유족,15~19세,34,20,14
2023-11-30,27,유족,20~24세,80,43,37
2023-11-30,28,유족,25~29세,143,83,60
2023-11-30,29,유족,30~34세,332,188,144
2023-11-30,30,유족,35~39세,638,364,274
2023-11-30,31,유족,40~44세,1895,1112,783
2023-11-30,32,유족,45~49세,4359,2758,1601
2023-11-30,33,유족,50~54세,8746,5652,3094
2023-11-30,34,유족,55~59세,13915,9320,4595
2023-11-30,35,유족,60~64세,27520,17669,9851
2023-11-30,36,유족,65~69세,43017,23625,19392
2023-11-30,37,유족,70~74세,48358,19001,29357
2023-11-30,38,유족,75~79세,31395,10049,21346
2023-11-30,39,유족,80~84세,23520,3657,19863
2023-11-30,40,유족,85~89세,35079,1678,33401
2023-11-30,41,유족,90~94세,17456,495,16961
2023-11-30,42,유족,95~99세,2714,104,2610
2023-11-30,43,유족,100세이상,421,52,369
2023-11-30,44,유족,해당없음,2,0,2
2023-10-31,1,본인,0~4세,0,0,0
2023-10-31,2,본인,5~9세,0,0,0
2023-10-31,3,본인,10~14세,0,0,0
2023-10-31,4,본인,15~19세,0,0,0
2023-10-31,5,본인,20~24세,379,371,8
2023-10-31,6,본인,25~29세,6128,5878,250
2023-10-31,7,본인,30~34세,14011,13173,838
2023-10-31,8,본인,35~39세,13762,12941,821
2023-10-31,9,본인,40~44세,14524,13818,706
2023-10-31,10,본인,45~49세,14806,14263,543
2023-10-31,11,본인,50~54세,14306,14014,292
2023-10-31,12,본인,55~59세,19605,19292,313
2023-10-31,13,본인,60~64세,23468,22917,551
2023-10-31,14,본인,65~69세,25335,25031,304
2023-10-31,15,본인,70~74세,51282,51087,195
2023-10-31,16,본인,75~79세,125248,125070,178
2023-10-31,17,본인,80~84세,29196,29002,194
2023-10-31,18,본인,85~89세,14253,13727,526
2023-10-31,19,본인,90~94세,32098,31543,555
2023-10-31,20,본인,95~99세,4953,4904,49
2023-10-31,21,본인,100세이상,280,273,7
2023-10-31,22,본인,해당없음,0,0,0
2023-10-31,23,유족,0~4세,0,0,0
2023-10-31,24,유족,5~9세,6,3,3
2023-10-31,25,유족,10~14세,16,12,4
2023-10-31,26,유족,15~19세,34,20,14
2023-10-31,27,유족,20~24세,82,45,37
2023-10-31,28,유족,25~29세,146,85,61
2023-10-31,29,유족,30~34세,336,190,146
2023-10-31,30,유족,35~39세,641,363,278
2023-10-31,31,유족,40~44세,1897,1117,780
2023-10-31,32,유족,45~49세,4376,2779,1597
2023-10-31,33,유족,50~54세,8724,5646,3078
2023-10-31,34,유족,55~59세,13861,9263,4598
2023-10-31,35,유족,60~64세,27696,17782,9914
2023-10-31,36,유족,65~69세,42707,23353,19354
2023-10-31,37,유족,70~74세,48391,19022,29369
2023-10-31,38,유족,75~79세,30812,9827,20985
2023-10-31,39,유족,80~84세,23697,3656,20041
2023-10-31,40,유족,85~89세,35212,1654,33558
2023-10-31,41,유족,90~94세,17284,495,16789
2023-10-31,42,유족,95~99세,2653,100,2553
2023-10-31,43,유족,100세이상,421,52,369
2023-10-31,44,유족,해당없음,3,0,3
2023-09-30,1,본인,0~4세,0,0,0
2023-09-30,2,본인,5~9세,0,0,0
2023-09-30,3,본인,10~14세,0,0,0
2023-09-30,4,본인,15~19세,0,0,0
2023-09-30,5,본인,20~24세,385,377,8
2023-09-30,6,본인,25~29세,6163,5906,257
2023-09-30,7,본인,30~34세,13996,13153,843
2023-09-30,8,본인,35~39세,13733,12914,819
2023-09-30,9,본인,40~44세,14471,13777,694
2023-09-30,10,본인,45~49세,14795,14254,541
2023-09-30,11,본인,50~54세,14270,13979,291
2023-09-30,12,본인,55~59세,19517,19212,305
2023-09-30,13,본인,60~64세,23550,22995,555
2023-09-30,14,본인,65~69세,25257,24958,299
2023-09-30,15,본인,70~74세,53412,53218,194
2023-09-30,16,본인,75~79세,124109,123931,178
2023-09-30,17,본인,80~84세,28570,28372,198
2023-09-30,18,본인,85~89세,14561,14031,530
2023-09-30,19,본인,90~94세,32583,32026,557
2023-09-30,20,본인,95~99세,4894,4847,47
2023-09-30,21,본인,100세이상,284,277,7
2023-09-30,22,본인,해당없음,0,0,0
2023-09-30,23,유족,0~4세,0,0,0
2023-09-30,24,유족,5~9세,6,3,3
2023-09-30,25,유족,10~14세,15,11,4
2023-09-30,26,유족,15~19세,35,21,14
2023-09-30,27,유족,20~24세,81,43,38
2023-09-30,28,유족,25~29세,147,86,61
2023-09-30,29,유족,30~34세,335,189,146
2023-09-30,30,유족,35~39세,652,369,283
2023-09-30,31,유족,40~44세,1907,1124,783
2023-09-30,32,유족,45~49세,4398,2802,1596
2023-09-30,33,유족,50~54세,8707,5637,3070
2023-09-30,34,유족,55~59세,13861,9273,4588
2023-09-30,35,유족,60~64세,27873,17880,9993
2023-09-30,36,유족,65~69세,42418,23043,19375
2023-09-30,37,유족,70~74세,48346,19004,29342
2023-09-30,38,유족,75~79세,30328,9632,20696
2023-09-30,39,유족,80~84세,23809,3623,20186
2023-09-30,40,유족,85~89세,35320,1630,33690
2023-09-30,41,유족,90~94세,17081,499,16582
2023-09-30,42,유족,95~99세,2604,101,2503
2023-09-30,43,유족,100세이상,424,52,372
2023-09-30,44,유족,해당없음,3,0,3
2023-08-31,1,본인,0~4세,0,0,0
2023-08-31,2,본인,5~9세,0,0,0
2023-08-31,3,본인,10~14세,0,0,0
2023-08-31,4,본인,15~19세,0,0,0
2023-08-31,5,본인,20~24세,387,378,9
2023-08-31,6,본인,25~29세,6151,5888,263
2023-08-31,7,본인,30~34세,13951,13106,845
2023-08-31,8,본인,35~39세,13671,12864,807
2023-08-31,9,본인,40~44세,14405,13712,693
2023-08-31,10,본인,45~49세,14785,14248,537
2023-08-31,11,본인,50~54세,14260,13978,282
2023-08-31,12,본인,55~59세,19417,19117,300
2023-08-31,13,본인,60~64세,23649,23099,550
2023-08-31,14,본인,65~69세,25215,24917,298
2023-08-31,15,본인,70~74세,55554,55360,194
2023-08-31,16,본인,75~79세,122991,122815,176
2023-08-31,17,본인,80~84세,27902,27703,199
2023-08-31,18,본인,85~89세,14956,14405,551
2023-08-31,19,본인,90~94세,32952,32405,547
2023-08-31,20,본인,95~99세,4817,4771,46
2023-08-31,21,본인,100세이상,291,284,7
2023-08-31,22,본인,해당없음,0,0,0
2023-08-31,23,유족,0~4세,0,0,0
2023-08-31,24,유족,5~9세,6,3,3
2023-08-31,25,유족,10~14세,16,12,4
2023-08-31,26,유족,15~19세,34,20,14
2023-08-31,27,유족,20~24세,80,44,36
2023-08-31,28,유족,25~29세,152,89,63
2023-08-31,29,유족,30~34세,334,185,149
2023-08-31,30,유족,35~39세,649,368,281
2023-08-31,31,유족,40~44세,1920,1128,792
2023-08-31,32,유족,45~49세,4400,2809,1591
2023-08-31,33,유족,50~54세,8734,5660,3074
2023-08-31,34,유족,55~59세,13836,9266,4570
2023-08-31,35,유족,60~64세,28028,17960,10068
2023-08-31,36,유족,65~69세,42106,22771,19335
2023-08-31,37,유족,70~74세,48273,18984,29289
2023-08-31,38,유족,75~79세,29874,9442,20432
2023-08-31,39,유족,80~84세,23880,3564,20316
2023-08-31,40,유족,85~89세,35480,1631,33849
2023-08-31,41,유족,90~94세,16914,484,16430
2023-08-31,42,유족,95~99세,2552,102,2450
2023-08-31,43,유족,100세이상,428,52,376
2023-08-31,44,유족,해당없음,3,0,3
2023-07-31,1,본인,0~4세,0,0,0
2023-07-31,2,본인,5~9세,0,0,0
2023-07-31,3,본인,10~14세,0,0,0
2023-07-31,4,본인,15~19세,0,0,0
2023-07-31,5,본인,20~24세,392,383,9
2023-07-31,6,본인,25~29세,6202,5927,275
2023-07-31,7,본인,30~34세,13838,12999,839
2023-07-31,8,본인,35~39세,13614,12808,806
2023-07-31,9,본인,40~44세,14354,13666,688
2023-07-31,10,본인,45~49세,14768,14235,533
2023-07-31,11,본인,50~54세,14158,13879,279
2023-07-31,12,본인,55~59세,19416,19127,289
2023-07-31,13,본인,60~64세,23729,23174,555
2023-07-31,14,본인,65~69세,25104,24815,289
2023-07-31,15,본인,70~74세,57661,57468,193
2023-07-31,16,본인,75~79세,121961,121782,179
2023-07-31,17,본인,80~84세,27189,26990,199
2023-07-31,18,본인,85~89세,15560,14990,570
2023-07-31,19,본인,90~94세,33088,32549,539
2023-07-31,20,본인,95~99세,4750,4705,45
2023-07-31,21,본인,100세이상,285,278,7
2023-07-31,22,본인,해당없음,0,0,0
2023-07-31,23,유족,0~4세,0,0,0
2023-07-31,24,유족,5~9세,6,3,3
2023-07-31,25,유족,10~14세,16,12,4
2023-07-31,26,유족,15~19세,35,21,14
2023-07-31,27,유족,20~24세,81,44,37
2023-07-31,28,유족,25~29세,153,90,63
2023-07-31,29,유족,30~34세,339,187,152
2023-07-31,30,유족,35~39세,654,372,282
2023-07-31,31,유족,40~44세,1941,1142,799
2023-07-31,32,유족,45~49세,4433,2839,1594
2023-07-31,33,유족,50~54세,8729,5652,3077
2023-07-31,34,유족,55~59세,13818,9263,4555
2023-07-31,35,유족,60~64세,28200,18032,10168
2023-07-31,36,유족,65~69세,41831,22533,19298
2023-07-31,37,유족,70~74세,48241,18964,29277
2023-07-31,38,유족,75~79세,29335,9203,20132
2023-07-31,39,유족,80~84세,24014,3544,20470
2023-07-31,40,유족,85~89세,35584,1622,33962
2023-07-31,41,유족,90~94세,16675,480,16195
2023-07-31,42,유족,95~99세,2507,106,2401
2023-07-31,43,유족,100세이상,423,52,371
2023-07-31,44,유족,해당없음,3,0,3
2023-06-30,1,본인,0~4세,0,0,0
2023-06-30,2,본인,5~9세,0,0,0
2023-06-30,3,본인,10~14세,0,0,0
2023-06-30,4,본인,15~19세,0,0,0
2023-06-30,5,본인,20~24세,389,380,9
2023-06-30,6,본인,25~29세,5989,5718,271
2023-06-30,7,본인,30~34세,13571,12757,814
2023-06-30,8,본인,35~39세,13572,12765,807
2023-06-30,9,본인,40~44세,14296,13615,681
2023-06-30,10,본인,45~49세,14685,14157,528
2023-06-30,11,본인,50~54세,14084,13806,278
2023-06-30,12,본인,55~59세,19285,18998,287
2023-06-30,13,본인,60~64세,23691,23151,540
2023-06-30,14,본인,65~69세,25099,24816,283
2023-06-30,15,본인,70~74세,59814,59623,191
2023-06-30,16,본인,75~79세,120697,120517,180
2023-06-30,17,본인,80~84세,26693,26492,201
2023-06-30,18,본인,85~89세,16103,15514,589
2023-06-30,19,본인,90~94세,33303,32767,536
2023-06-30,20,본인,95~99세,4716,4672,44
2023-06-30,21,본인,100세이상,284,277,7
2023-06-30,22,본인,해당없음,0,0,0
2023-06-30,23,유족,0~4세,0,0,0
2023-06-30,24,유족,5~9세,6,3,3
2023-06-30,25,유족,10~14세,16,12,4
2023-06-30,26,유족,15~19세,37,21,16
2023-06-30,27,유족,20~24세,77,42,35
2023-06-30,28,유족,25~29세,156,91,65
2023-06-30,29,유족,30~34세,345,189,156
2023-06-30,30,유족,35~39세,655,375,280
2023-06-30,31,유족,40~44세,1947,1152,795
2023-06-30,32,유족,45~49세,4472,2858,1614
2023-06-30,33,유족,50~54세,8765,5681,3084
2023-06-30,34,유족,55~59세,13760,9232,4528
2023-06-30,35,유족,60~64세,28244,18022,10222
2023-06-30,36,유족,65~69세,41661,22352,19309
2023-06-30,37,유족,70~74세,48202,18942,29260
2023-06-30,38,유족,75~79세,28867,9023,19844
2023-06-30,39,유족,80~84세,24191,3544,20647
2023-06-30,40,유족,85~89세,35605,1595,34010
2023-06-30,41,유족,90~94세,16542,477,16065
2023-06-30,42,유족,95~99세,2479,105,2374
2023-06-30,43,유족,100세이상,427,53,374
2023-06-30,44,유족,해당없음,3,0,3
2023-05-31,1,본인,0~4세,0,0,0
2023-05-31,2,본인,5~9세,0,0,0
2023-05-31,3,본인,10~14세,0,0,0
2023-05-31,4,본인,15~19세,0,0,0
2023-05-31,5,본인,20~24세,385,380,5
2023-05-31,6,본인,25~29세,5766,5511,255
2023-05-31,7,본인,30~34세,13508,12713,795
2023-05-31,8,본인,35~39세,13546,12737,809
2023-05-31,9,본인,40~44세,14269,13595,674
2023-05-31,10,본인,45~49세,14647,14124,523
2023-05-31,11,본인,50~54세,13974,13701,273
2023-05-31,12,본인,55~59세,19254,18971,283
2023-05-31,13,본인,60~64세,23689,23147,542
2023-05-31,14,본인,65~69세,25109,24829,280
2023-05-31,15,본인,70~74세,61637,61445,192
2023-05-31,16,본인,75~79세,119710,119532,178
2023-05-31,17,본인,80~84세,26144,25942,202
2023-05-31,18,본인,85~89세,16587,15981,606
2023-05-31,19,본인,90~94세,33520,32989,531
2023-05-31,20,본인,95~99세,4673,4632,41
2023-05-31,21,본인,100세이상,278,271,7
2023-05-31,22,본인,해당없음,0,0,0
2023-05-31,23,유족,0~4세,0,0,0
2023-05-31,24,유족,5~9세,6,3,3
2023-05-31,25,유족,10~14세,15,12,3
2023-05-31,26,유족,15~19세,38,21,17
2023-05-31,27,유족,20~24세,79,44,35
2023-05-31,28,유족,25~29세,156,89,67
2023-05-31,29,유족,30~34세,345,189,156
2023-05-31,30,유족,35~39세,659,379,280
2023-05-31,31,유족,40~44세,1968,1177,791
2023-05-31,32,유족,45~49세,4500,2870,1630
2023-05-31,33,유족,50~54세,8720,5653,3067
2023-05-31,34,유족,55~59세,13789,9253,4536
2023-05-31,35,유족,60~64세,28228,18009,10219
2023-05-31,36,유족,65~69세,41458,22128,19330
2023-05-31,37,유족,70~74세,48135,18922,29213
2023-05-31,38,유족,75~79세,28425,8864,19561
2023-05-31,39,유족,80~84세,24263,3507,20756
2023-05-31,40,유족,85~89세,35700,1597,34103
2023-05-31,41,유족,90~94세,16485,485,16000
2023-05-31,42,유족,95~99세,2479,103,2376
2023-05-31,43,유족,100세이상,413,53,360
2023-05-31,44,유족,해당없음,3,0,3
2023-04-30,1,본인,0~4세,0,0,0
2023-04-30,2,본인,5~9세,0,0,0
2023-04-30,3,본인,10~14세,0,0,0
2023-04-30,4,본인,15~19세,0,0,0
2023-04-30,5,본인,20~24세,381,378,3
2023-04-30,6,본인,25~29세,5821,5570,251
2023-04-30,7,본인,30~34세,13459,12656,803
2023-04-30,8,본인,35~39세,13520,12719,801
2023-04-30,9,본인,40~44세,14232,13565,667
2023-04-30,10,본인,45~49세,14617,14104,513
2023-04-30,11,본인,50~54세,13884,13614,270
2023-04-30,12,본인,55~59세,19235,18955,280
2023-04-30,13,본인,60~64세,23736,23192,544
2023-04-30,14,본인,65~69세,25150,24872,278
2023-04-30,15,본인,70~74세,63816,63627,189
2023-04-30,16,본인,75~79세,118477,118297,180
2023-04-30,17,본인,80~84세,25528,25325,203
2023-04-30,18,본인,85~89세,17282,16656,626
2023-04-30,19,본인,90~94세,33597,33078,519
2023-04-30,20,본인,95~99세,4614,4575,39
2023-04-30,21,본인,100세이상,269,262,7
2023-04-30,22,본인,해당없음,0,0,0
2023-04-30,23,유족,0~4세,0,0,0
2023-04-30,24,유족,5~9세,6,3,3
2023-04-30,25,유족,10~14세,15,12,3
2023-04-30,26,유족,15~19세,39,21,18
2023-04-30,27,유족,20~24세,77,43,34
2023-04-30,28,유족,25~29세,159,93,66
2023-04-30,29,유족,30~34세,343,189,154
2023-04-30,30,유족,35~39세,663,379,284
2023-04-30,31,유족,40~44세,1963,1181,782
2023-04-30,32,유족,45~49세,4544,2897,1647
2023-04-30,33,유족,50~54세,8671,5632,3039
2023-04-30,34,유족,55~59세,13752,9227,4525
2023-04-30,35,유족,60~64세,28307,18069,10238
2023-04-30,36,유족,65~69세,41321,21967,19354
2023-04-30,37,유족,70~74세,47821,18793,29028
2023-04-30,38,유족,75~79세,27948,8677,19271
2023-04-30,39,유족,80~84세,24455,3484,20971
2023-04-30,40,유족,85~89세,35847,1589,34258
2023-04-30,41,유족,90~94세,16298,486,15812
2023-04-30,42,유족,95~99세,2432,102,2330
2023-04-30,43,유족,100세이상,413,54,359
2023-04-30,44,유족,해당없음,3,0,3
2023-03-31,1,본인,0~4세,0,0,0
2023-03-31,2,본인,5~9세,0,0,0
2023-03-31,3,본인,10~14세,0,0,0
2023-03-31,4,본인,15~19세,0,0,0
2023-03-31,5,본인,20~24세,372,369,3
2023-03-31,6,본인,25~29세,5869,5616,253
2023-03-31,7,본인,30~34세,13402,12594,808
2023-03-31,8,본인,35~39세,13489,12692,797
2023-03-31,9,본인,40~44세,14187,13526,661
2023-03-31,10,본인,45~49세,14610,14102,508
2023-03-31,11,본인,50~54세,13748,13481,267
2023-03-31,12,본인,55~59세,19235,18953,282
2023-03-31,13,본인,60~64세,23731,23186,545
2023-03-31,14,본인,65~69세,25137,24867,270
2023-03-31,15,본인,70~74세,65937,65748,189
2023-03-31,16,본인,75~79세,117362,117184,178
2023-03-31,17,본인,80~84세,24781,24575,206
2023-03-31,18,본인,85~89세,17950,17316,634
2023-03-31,19,본인,90~94세,33600,33089,511
2023-03-31,20,본인,95~99세,4553,4514,39
2023-03-31,21,본인,100세이상,257,250,7
2023-03-31,22,본인,해당없음,0,0,0
2023-03-31,23,유족,0~4세,0,0,0
2023-03-31,24,유족,5~9세,7,4,3
2023-03-31,25,유족,10~14세,13,10,3
2023-03-31,26,유족,15~19세,37,19,18
2023-03-31,27,유족,20~24세,79,45,34
2023-03-31,28,유족,25~29세,158,93,65
2023-03-31,29,유족,30~34세,343,188,155
2023-03-31,30,유족,35~39세,674,385,289
2023-03-31,31,유족,40~44세,1979,1196,783
2023-03-31,32,유족,45~49세,4545,2887,1658
2023-03-31,33,유족,50~54세,8642,5627,3015
2023-03-31,34,유족,55~59세,13839,9309,4530
2023-03-31,35,유족,60~64세,28196,17955,10241
2023-03-31,36,유족,65~69세,41085,21720,19365
2023-03-31,37,유족,70~74세,47666,18724,28942
2023-03-31,38,유족,75~79세,27553,8504,19049
2023-03-31,39,유족,80~84세,24720,3476,21244
2023-03-31,40,유족,85~89세,35932,1573,34359
2023-03-31,41,유족,90~94세,16110,485,15625
2023-03-31,42,유족,95~99세,2403,102,2301
2023-03-31,43,유족,100세이상,406,53,353
2023-03-31,44,유족,해당없음,3,0,3
2023-02-28,1,본인,0~4세,0,0,0
2023-02-28,2,본인,5~9세,0,0,0
2023-02-28,3,본인,10~14세,0,0,0
2023-02-28,4,본인,15~19세,0,0,0
2023-02-28,5,본인,20~24세,342,340,2
2023-02-28,6,본인,25~29세,5687,5458,229
2023-02-28,7,본인,30~34세,13290,12487,803
2023-02-28,8,본인,35~39세,13459,12661,798
2023-02-28,9,본인,40~44세,14126,13474,652
2023-02-28,10,본인,45~49세,14615,14118,497
2023-02-28,11,본인,50~54세,13657,13390,267
2023-02-28,12,본인,55~59세,19250,18969,281
2023-02-28,13,본인,60~64세,23759,23209,550
2023-02-28,14,본인,65~69세,25106,24839,267
2023-02-28,15,본인,70~74세,68392,68204,188
2023-02-28,16,본인,75~79세,116165,115989,176
2023-02-28,17,본인,80~84세,23919,23712,207
2023-02-28,18,본인,85~89세,18752,18101,651
2023-02-28,19,본인,90~94세,33779,33281,498
2023-02-28,20,본인,95~99세,4478,4439,39
2023-02-28,21,본인,100세이상,254,247,7
2023-02-28,22,본인,해당없음,0,0,0
2023-02-28,23,유족,0~4세,0,0,0
2023-02-28,24,유족,5~9세,7,4,3
2023-02-28,25,유족,10~14세,13,10,3
2023-02-28,26,유족,15~19세,37,19,18
2023-02-28,27,유족,20~24세,78,45,33
2023-02-28,28,유족,25~29세,156,90,66
2023-02-28,29,유족,30~34세,339,185,154
2023-02-28,30,유족,35~39세,680,384,296
2023-02-28,31,유족,40~44세,1980,1203,777
2023-02-28,32,유족,45~49세,4577,2916,1661
2023-02-28,33,유족,50~54세,8645,5626,3019
2023-02-28,34,유족,55~59세,13827,9311,4516
2023-02-28,35,유족,60~64세,28232,17979,10253
2023-02-28,36,유족,65~69세,40853,21420,19433
2023-02-28,37,유족,70~74세,47448,18659,28789
2023-02-28,38,유족,75~79세,27092,8309,18783
2023-02-28,39,유족,80~84세,24979,3459,21520
2023-02-28,40,유족,85~89세,35960,1565,34395
2023-02-28,41,유족,90~94세,15915,482,15433
2023-02-28,42,유족,95~99세,2322,101,2221
2023-02-28,43,유족,100세이상,391,52,339
2023-02-28,44,유족,해당없음,3,0,3
2023-01-31,1,본인,0~4세,0,0,0
2023-01-31,2,본인,5~9세,0,0,0
2023-01-31,3,본인,10~14세,0,0,0
2023-01-31,4,본인,15~19세,0,0,0
2023-01-31,5,본인,20~24세,347,346,1
2023-01-31,6,본인,25~29세,5800,5557,243
2023-01-31,7,본인,30~34세,13290,12479,811
2023-01-31,8,본인,35~39세,13419,12639,780
2023-01-31,9,본인,40~44세,14083,13435,648
2023-01-31,10,본인,45~49세,14494,14013,481
2023-01-31,11,본인,50~54세,13585,13318,267
2023-01-31,12,본인,55~59세,19283,19007,276
2023-01-31,13,본인,60~64세,23727,23182,545
2023-01-31,14,본인,65~69세,25120,24856,264
2023-01-31,15,본인,70~74세,71114,70924,190
2023-01-31,16,본인,75~79세,115072,114898,174
2023-01-31,17,본인,80~84세,22715,22506,209
2023-01-31,18,본인,85~89세,19669,19001,668
2023-01-31,19,본인,90~94세,34075,33586,489
2023-01-31,20,본인,95~99세,4411,4374,37
2023-01-31,21,본인,100세이상,222,215,7
2023-01-31,22,본인,해당없음,0,0,0
2023-01-31,23,유족,0~4세,0,0,0
2023-01-31,24,유족,5~9세,7,4,3
2023-01-31,25,유족,10~14세,13,10,3
2023-01-31,26,유족,15~19세,38,19,19
2023-01-31,27,유족,20~24세,79,45,34
2023-01-31,28,유족,25~29세,158,93,65
2023-01-31,29,유족,30~34세,342,184,158
2023-01-31,30,유족,35~39세,696,391,305
2023-01-31,31,유족,40~44세,1993,1218,775
2023-01-31,32,유족,45~49세,4591,2928,1663
2023-01-31,33,유족,50~54세,8657,5636,3021
2023-01-31,34,유족,55~59세,13873,9351,4522
2023-01-31,35,유족,60~64세,28221,17955,10266
2023-01-31,36,유족,65~69세,40585,21172,19413
2023-01-31,37,유족,70~74세,47331,18604,28727
2023-01-31,38,유족,75~79세,26652,8133,18519
2023-01-31,39,유족,80~84세,25154,3416,21738
2023-01-31,40,유족,85~89세,36025,1544,34481
2023-01-31,41,유족,90~94세,15641,485,15156
2023-01-31,42,유족,95~99세,2247,99,2148
2023-01-31,43,유족,100세이상,384,51,333
2023-01-31,44,유족,해당없음,3,0,3
2022-12-31,1,본인,0~4세,0,0,0
2022-12-31,2,본인,5~9세,0,0,0
2022-12-31,3,본인,10~14세,0,0,0
2022-12-31,4,본인,15~19세,0,0,0
2022-12-31,5,본인,20~24세,340,340,0
2022-12-31,6,본인,25~29세,5851,5605,246
2022-12-31,7,본인,30~34세,13289,12478,811
2022-12-31,8,본인,35~39세,13395,12625,770
2022-12-31,9,본인,40~44세,13974,13327,647
2022-12-31,10,본인,45~49세,14396,13926,470
2022-12-31,11,본인,50~54세,13464,13205,259
2022-12-31,12,본인,55~59세,19283,19006,277
2022-12-31,13,본인,60~64세,23699,23172,527
2022-12-31,14,본인,65~69세,25057,24804,253
2022-12-31,15,본인,70~74세,73923,73731,192
2022-12-31,16,본인,75~79세,113669,113496,173
2022-12-31,17,본인,80~84세,21587,21376,211
2022-12-31,18,본인,85~89세,20531,19848,683
2022-12-31,19,본인,90~94세,34056,33581,475
2022-12-31,20,본인,95~99세,4272,4238,34
2022-12-31,21,본인,100세이상,205,198,7
2022-12-31,22,본인,해당없음,0,0,0
2022-12-31,23,유족,0~4세,0,0,0
2022-12-31,24,유족,5~9세,7,4,3
2022-12-31,25,유족,10~14세,13,10,3
2022-12-31,26,유족,15~19세,38,19,19
2022-12-31,27,유족,20~24세,76,42,34
2022-12-31,28,유족,25~29세,162,94,68
2022-12-31,29,유족,30~34세,339,184,155
2022-12-31,30,유족,35~39세,716,406,310
2022-12-31,31,유족,40~44세,1997,1224,773
2022-12-31,32,유족,45~49세,4623,2952,1671
2022-12-31,33,유족,50~54세,8662,5632,3030
2022-12-31,34,유족,55~59세,13943,9426,4517
2022-12-31,35,유족,60~64세,28286,17963,10323
2022-12-31,36,유족,65~69세,40391,20920,19471
2022-12-31,37,유족,70~74세,47108,18514,28594
2022-12-31,38,유족,75~79세,26185,7926,18259
2022-12-31,39,유족,80~84세,25381,3373,22008
2022-12-31,40,유족,85~89세,36056,1511,34545
2022-12-31,41,유족,90~94세,15356,482,14874
2022-12-31,42,유족,95~99세,2185,99,2086
2022-12-31,43,유족,100세이상,382,49,333
2022-12-31,44,유족,해당없음,3,0,3
2022-11-30,1,본인,0~4세,0,0,0
2022-11-30,2,본인,5~9세,0,0,0
2022-11-30,3,본인,10~14세,0,0,0
2022-11-30,4,본인,15~19세,0,0,0
2022-11-30,5,본인,20~24세,338,338,0
2022-11-30,6,본인,25~29세,5887,5634,253
2022-11-30,7,본인,30~34세,13222,12413,809
2022-11-30,8,본인,35~39세,13370,12612,758
2022-11-30,9,본인,40~44세,13996,13337,659
2022-11-30,10,본인,45~49세,14275,13827,448
2022-11-30,11,본인,50~54세,13445,13186,259
2022-11-30,12,본인,55~59세,19316,19041,275
2022-11-30,13,본인,60~64세,23750,23222,528
2022-11-30,14,본인,65~69세,25022,24771,251
2022-11-30,15,본인,70~74세,76095,75899,196
2022-11-30,16,본인,75~79세,112283,112119,164
2022-11-30,17,본인,80~84세,21263,21046,217
2022-11-30,18,본인,85~89세,21566,20868,698
2022-11-30,19,본인,90~94세,34020,33563,457
2022-11-30,20,본인,95~99세,4187,4153,34
2022-11-30,21,본인,100세이상,207,200,7
2022-11-30,22,본인,해당없음,0,0,0
2022-11-30,23,유족,0~4세,0,0,0
2022-11-30,24,유족,5~9세,7,4,3
2022-11-30,25,유족,10~14세,12,9,3
2022-11-30,26,유족,15~19세,40,19,21
2022-11-30,27,유족,20~24세,74,42,32
2022-11-30,28,유족,25~29세,164,95,69
2022-11-30,29,유족,30~34세,337,184,153
2022-11-30,30,유족,35~39세,718,413,305
2022-11-30,31,유족,40~44세,2023,1230,793
2022-11-30,32,유족,45~49세,4645,2977,1668
2022-11-30,33,유족,50~54세,8621,5599,3022
2022-11-30,34,유족,55~59세,13998,9458,4540
2022-11-30,35,유족,60~64세,28268,17936,10332
2022-11-30,36,유족,65~69세,40130,20662,19468
2022-11-30,37,유족,70~74세,46959,18481,28478
2022-11-30,38,유족,75~79세,25745,7740,18005
2022-11-30,39,유족,80~84세,25660,3349,22311
2022-11-30,40,유족,85~89세,36145,1505,34640
2022-11-30,41,유족,90~94세,15082,478,14604
2022-11-30,42,유족,95~99세,2136,100,2036
2022-11-30,43,유족,100세이상,380,48,332
2022-11-30,44,유족,해당없음,3,0,3
2022-10-31,1,본인,0~4세,0,0,0
2022-10-31,2,본인,5~9세,0,0,0
2022-10-31,3,본인,10~14세,0,0,0
2022-10-31,4,본인,15~19세,0,0,0
2022-10-31,5,본인,20~24세,343,343,0
2022-10-31,6,본인,25~29세,6015,5749,266
2022-10-31,7,본인,30~34세,13133,12326,807
2022-10-31,8,본인,35~39세,13379,12631,748
2022-10-31,9,본인,40~44세,13943,13281,662
2022-10-31,10,본인,45~49세,14189,13753,436
2022-10-31,11,본인,50~54세,13396,13139,257
2022-10-31,12,본인,55~59세,19404,19126,278
2022-10-31,13,본인,60~64세,23757,23234,523
2022-10-31,14,본인,65~69세,24958,24706,252
2022-10-31,15,본인,70~74세,77953,77759,194
2022-10-31,16,본인,75~79세,111188,111026,162
2022-10-31,17,본인,80~84세,21014,20791,223
2022-10-31,18,본인,85~89세,22318,21605,713
2022-10-31,19,본인,90~94세,34066,33616,450
2022-10-31,20,본인,95~99세,4123,4090,33
2022-10-31,21,본인,100세이상,205,198,7
2022-10-31,22,본인,해당없음,0,0,0
2022-10-31,23,유족,0~4세,0,0,0
2022-10-31,24,유족,5~9세,7,4,3
2022-10-31,25,유족,10~14세,11,9,2
2022-10-31,26,유족,15~19세,40,19,21
2022-10-31,27,유족,20~24세,74,43,31
2022-10-31,28,유족,25~29세,164,96,68
2022-10-31,29,유족,30~34세,338,182,156
2022-10-31,30,유족,35~39세,728,418,310
2022-10-31,31,유족,40~44세,2042,1253,789
2022-10-31,32,유족,45~49세,4620,2957,1663
2022-10-31,33,유족,50~54세,8579,5572,3007
2022-10-31,34,유족,55~59세,14088,9508,4580
2022-10-31,35,유족,60~64세,28285,17909,10376
2022-10-31,36,유족,65~69세,39832,20408,19424
2022-10-31,37,유족,70~74세,46715,18390,28325
2022-10-31,38,유족,75~79세,25450,7613,17837
2022-10-31,39,유족,80~84세,25747,3303,22444
2022-10-31,40,유족,85~89세,36271,1504,34767
2022-10-31,41,유족,90~94세,14912,472,14440
2022-10-31,42,유족,95~99세,2099,101,1998
2022-10-31,43,유족,100세이상,382,47,335
2022-10-31,44,유족,해당없음,3,0,3
2022-09-30,1,본인,0~4세,0,0,0
2022-09-30,2,본인,5~9세,0,0,0
2022-09-30,3,본인,10~14세,0,0,0
2022-09-30,4,본인,15~19세,0,0,0
2022-09-30,5,본인,20~24세,352,350,2
2022-09-30,6,본인,25~29세,6080,5812,268
2022-09-30,7,본인,30~34세,13108,12302,806
2022-09-30,8,본인,35~39세,13377,12632,745
2022-09-30,9,본인,40~44세,13874,13211,663
2022-09-30,10,본인,45~49세,14155,13732,423
2022-09-30,11,본인,50~54세,13297,13042,255
2022-09-30,12,본인,55~59세,19489,19209,280
2022-09-30,13,본인,60~64세,23755,23235,520
2022-09-30,14,본인,65~69세,24936,24689,247
2022-09-30,15,본인,70~74세,80039,79847,192
2022-09-30,16,본인,75~79세,109753,109589,164
2022-09-30,17,본인,80~84세,20524,20296,228
2022-09-30,18,본인,85~89세,23057,22336,721
2022-09-30,19,본인,90~94세,33994,33553,441
2022-09-30,20,본인,95~99세,4048,4016,32
2022-09-30,21,본인,100세이상,204,197,7
2022-09-30,22,본인,해당없음,0,0,0
2022-09-30,23,유족,0~4세,0,0,0
2022-09-30,24,유족,5~9세,8,5,3
2022-09-30,25,유족,10~14세,10,8,2
2022-09-30,26,유족,15~19세,40,19,21
2022-09-30,27,유족,20~24세,76,45,31
2022-09-30,28,유족,25~29세,165,96,69
2022-09-30,29,유족,30~34세,336,178,158
2022-09-30,30,유족,35~39세,731,423,308
2022-09-30,31,유족,40~44세,2065,1261,804
2022-09-30,32,유족,45~49세,4619,2957,1662
2022-09-30,33,유족,50~54세,8613,5607,3006
2022-09-30,34,유족,55~59세,14230,9588,4642
2022-09-30,35,유족,60~64세,28408,17956,10452
2022-09-30,36,유족,65~69세,39621,20199,19422
2022-09-30,37,유족,70~74세,46511,18246,28265
2022-09-30,38,유족,75~79세,25205,7505,17700
2022-09-30,39,유족,80~84세,25760,3241,22519
2022-09-30,40,유족,85~89세,36265,1488,34777
2022-09-30,41,유족,90~94세,14688,479,14209
2022-09-30,42,유족,95~99세,2045,98,1947
2022-09-30,43,유족,100세이상,381,48,333
2022-09-30,44,유족,해당없음,3,0,3
2022-08-31,1,본인,0~4세,0,0,0
2022-08-31,2,본인,5~9세,0,0,0
2022-08-31,3,본인,10~14세,0,0,0
2022-08-31,4,본인,15~19세,1,1,0
2022-08-31,5,본인,20~24세,327,325,2
2022-08-31,6,본인,25~29세,6082,5815,267
2022-08-31,7,본인,30~34세,13023,12213,810
2022-08-31,8,본인,35~39세,13345,12612,733
2022-08-31,9,본인,40~44세,13846,13187,659
2022-08-31,10,본인,45~49세,14100,13688,412
2022-08-31,11,본인,50~54세,13191,12942,249
2022-08-31,12,본인,55~59세,19565,19290,275
2022-08-31,13,본인,60~64세,23801,23279,522
2022-08-31,14,본인,65~69세,24918,24676,242
2022-08-31,15,본인,70~74세,82068,81873,195
2022-08-31,16,본인,75~79세,108252,108090,162
2022-08-31,17,본인,80~84세,20204,19974,230
2022-08-31,18,본인,85~89세,23829,23097,732
2022-08-31,19,본인,90~94세,33998,33564,434
2022-08-31,20,본인,95~99세,3969,3936,33
2022-08-31,21,본인,100세이상,207,200,7
2022-08-31,22,본인,해당없음,0,0,0
2022-08-31,23,유족,0~4세,0,0,0
2022-08-31,24,유족,5~9세,8,5,3
2022-08-31,25,유족,10~14세,10,8,2
2022-08-31,26,유족,15~19세,42,20,22
2022-08-31,27,유족,20~24세,77,45,32
2022-08-31,28,유족,25~29세,162,95,67
2022-08-31,29,유족,30~34세,337,178,159
2022-08-31,30,유족,35~39세,746,431,315
2022-08-31,31,유족,40~44세,2074,1262,812
2022-08-31,32,유족,45~49세,4647,2978,1669
2022-08-31,33,유족,50~54세,8582,5592,2990
2022-08-31,34,유족,55~59세,14276,9616,4660
2022-08-31,35,유족,60~64세,28565,18054,10511
2022-08-31,36,유족,65~69세,39376,19945,19431
2022-08-31,37,유족,70~74세,46299,18130,28169
2022-08-31,38,유족,75~79세,24807,7340,17467
2022-08-31,39,유족,80~84세,25854,3209,22645
2022-08-31,40,유족,85~89세,36343,1491,34852
2022-08-31,41,유족,90~94세,14461,464,13997
2022-08-31,42,유족,95~99세,1997,100,1897
2022-08-31,43,유족,100세이상,378,47,331
2022-08-31,44,유족,해당없음,3,0,3
2022-07-31,1,본인,0~4세,0,0,0
2022-07-31,2,본인,5~9세,0,0,0
2022-07-31,3,본인,10~14세,0,0,0
2022-07-31,4,본인,15~19세,2,2,0
2022-07-31,5,본인,20~24세,327,324,3
2022-07-31,6,본인,25~29세,6107,5833,274
2022-07-31,7,본인,30~34세,12963,12149,814
2022-07-31,8,본인,35~39세,13352,12630,722
2022-07-31,9,본인,40~44세,13764,13115,649
2022-07-31,10,본인,45~49세,14078,13670,408
2022-07-31,11,본인,50~54세,13104,12858,246
2022-07-31,12,본인,55~59세,19655,19384,271
2022-07-31,13,본인,60~64세,23848,23326,522
2022-07-31,14,본인,65~69세,24897,24661,236
2022-07-31,15,본인,70~74세,84131,83937,194
2022-07-31,16,본인,75~79세,106723,106560,163
2022-07-31,17,본인,80~84세,19887,19657,230
2022-07-31,18,본인,85~89세,24927,24177,750
2022-07-31,19,본인,90~94세,33741,33313,428
2022-07-31,20,본인,95~99세,3851,3820,31
2022-07-31,21,본인,100세이상,203,197,6
2022-07-31,22,본인,해당없음,0,0,0
2022-07-31,23,유족,0~4세,0,0,0
2022-07-31,24,유족,5~9세,8,5,3
2022-07-31,25,유족,10~14세,10,8,2
2022-07-31,26,유족,15~19세,43,21,22
2022-07-31,27,유족,20~24세,77,44,33
2022-07-31,28,유족,25~29세,164,97,67
2022-07-31,29,유족,30~34세,339,180,159
2022-07-31,30,유족,35~39세,745,430,315
2022-07-31,31,유족,40~44세,2083,1267,816
2022-07-31,32,유족,45~49세,4683,3004,1679
2022-07-31,33,유족,50~54세,8505,5548,2957
2022-07-31,34,유족,55~59세,14325,9649,4676
2022-07-31,35,유족,60~64세,28857,18244,10613
2022-07-31,36,유족,65~69세,39011,19600,19411
2022-07-31,37,유족,70~74세,46075,18041,28034
2022-07-31,38,유족,75~79세,24471,7205,17266
2022-07-31,39,유족,80~84세,25949,3174,22775
2022-07-31,40,유족,85~89세,36405,1489,34916
2022-07-31,41,유족,90~94세,14273,459,13814
2022-07-31,42,유족,95~99세,1940,99,1841
2022-07-31,43,유족,100세이상,371,47,324
2022-07-31,44,유족,해당없음,3,0,3
2022-06-30,1,본인,0~4세,0,0,0
2022-06-30,2,본인,5~9세,0,0,0
2022-06-30,3,본인,10~14세,0,0,0
2022-06-30,4,본인,15~19세,0,0,0
2022-06-30,5,본인,20~24세,325,322,3
2022-06-30,6,본인,25~29세,5924,5646,278
2022-06-30,7,본인,30~34세,12800,11995,805
2022-06-30,8,본인,35~39세,13338,12617,721
2022-06-30,9,본인,40~44세,13685,13037,648
2022-06-30,10,본인,45~49세,13998,13600,398
2022-06-30,11,본인,50~54세,12941,12697,244
2022-06-30,12,본인,55~59세,19760,19484,276
2022-06-30,13,본인,60~64세,23778,23273,505
2022-06-30,14,본인,65~69세,24922,24693,229
2022-06-30,15,본인,70~74세,86026,85831,195
2022-06-30,16,본인,75~79세,105349,105185,164
2022-06-30,17,본인,80~84세,19593,19365,228
2022-06-30,18,본인,85~89세,25893,25126,767
2022-06-30,19,본인,90~94세,33584,33164,420
2022-06-30,20,본인,95~99세,3847,3816,31
2022-06-30,21,본인,100세이상,200,194,6
2022-06-30,22,본인,해당없음,0,0,0
2022-06-30,23,유족,0~4세,0,0,0
2022-06-30,24,유족,5~9세,9,5,4
2022-06-30,25,유족,10~14세,10,9,1
2022-06-30,26,유족,15~19세,42,20,22
2022-06-30,27,유족,20~24세,76,43,33
2022-06-30,28,유족,25~29세,167,98,69
2022-06-30,29,유족,30~34세,337,179,158
2022-06-30,30,유족,35~39세,753,439,314
2022-06-30,31,유족,40~44세,2094,1270,824
2022-06-30,32,유족,45~49세,4684,3008,1676
2022-06-30,33,유족,50~54세,8462,5519,2943
2022-06-30,34,유족,55~59세,14326,9668,4658
2022-06-30,35,유족,60~64세,28893,18242,10651
2022-06-30,36,유족,65~69세,38890,19430,19460
2022-06-30,37,유족,70~74세,45831,17937,27894
2022-06-30,38,유족,75~79세,24158,7063,17095
2022-06-30,39,유족,80~84세,26018,3118,22900
2022-06-30,40,유족,85~89세,36466,1494,34972
2022-06-30,41,유족,90~94세,14158,452,13706
2022-06-30,42,유족,95~99세,1928,98,1830
2022-06-30,43,유족,100세이상,370,48,322
2022-06-30,44,유족,해당없음,4,0,4
2022-05-31,1,본인,0~4세,0,0,0
2022-05-31,2,본인,5~9세,0,0,0
2022-05-31,3,본인,10~14세,0,0,0
2022-05-31,4,본인,15~19세,0,0,0
2022-05-31,5,본인,20~24세,316,314,2
2022-05-31,6,본인,25~29세,5817,5550,267
2022-05-31,7,본인,30~34세,12728,11926,802
2022-05-31,8,본인,35~39세,13337,12631,706
2022-05-31,9,본인,40~44세,13630,12980,650
2022-05-31,10,본인,45~49세,13905,13517,388
2022-05-31,11,본인,50~54세,12868,12624,244
2022-05-31,12,본인,55~59세,19774,19501,273
2022-05-31,13,본인,60~64세,23792,23287,505
2022-05-31,14,본인,65~69세,25007,24780,227
2022-05-31,15,본인,70~74세,87827,87632,195
2022-05-31,16,본인,75~79세,104089,103925,164
2022-05-31,17,본인,80~84세,19309,19078,231
2022-05-31,18,본인,85~89세,26854,26078,776
2022-05-31,19,본인,90~94세,33682,33268,414
2022-05-31,20,본인,95~99세,3819,3789,30
2022-05-31,21,본인,100세이상,202,196,6
2022-05-31,22,본인,해당없음,0,0,0
2022-05-31,23,유족,0~4세,0,0,0
2022-05-31,24,유족,5~9세,9,5,4
2022-05-31,25,유족,10~14세,10,9,1
2022-05-31,26,유족,15~19세,42,20,22
2022-05-31,27,유족,20~24세,74,42,32
2022-05-31,28,유족,25~29세,169,98,71
2022-05-31,29,유족,30~34세,335,178,157
2022-05-31,30,유족,35~39세,756,438,318
2022-05-31,31,유족,40~44세,2109,1277,832
2022-05-31,32,유족,45~49세,4667,2988,1679
2022-05-31,33,유족,50~54세,8435,5504,2931
2022-05-31,34,유족,55~59세,14300,9657,4643
2022-05-31,35,유족,60~64세,28792,18183,10609
2022-05-31,36,유족,65~69세,38812,19305,19507
2022-05-31,37,유족,70~74세,45426,17784,27642
2022-05-31,38,유족,75~79세,23876,6930,16946
2022-05-31,39,유족,80~84세,26074,3101,22973
2022-05-31,40,유족,85~89세,36581,1484,35097
2022-05-31,41,유족,90~94세,14092,453,13639
2022-05-31,42,유족,95~99세,1926,101,1825
2022-05-31,43,유족,100세이상,373,47,326
2022-05-31,44,유족,해당없음,7,1,6
2022-04-30,1,본인,0~4세,0,0,0
2022-04-30,2,본인,5~9세,0,0,0
2022-04-30,3,본인,10~14세,0,0,0
2022-04-30,4,본인,15~19세,0,0,0
2022-04-30,5,본인,20~24세,307,305,2
2022-04-30,6,본인,25~29세,5824,5559,265
2022-04-30,7,본인,30~34세,12653,11846,807
2022-04-30,8,본인,35~39세,13350,12656,694
2022-04-30,9,본인,40~44세,13595,12949,646
2022-04-30,10,본인,45~49세,13808,13420,388
2022-04-30,11,본인,50~54세,12788,12552,236
2022-04-30,12,본인,55~59세,19810,19536,274
2022-04-30,13,본인,60~64세,23819,23318,501
2022-04-30,14,본인,65~69세,25166,24937,229
2022-04-30,15,본인,70~74세,89652,89456,196
2022-04-30,16,본인,75~79세,102783,102620,163
2022-04-30,17,본인,80~84세,18960,18729,231
2022-04-30,18,본인,85~89세,28122,27337,785
2022-04-30,19,본인,90~94세,33547,33139,408
2022-04-30,20,본인,95~99세,3798,3766,32
2022-04-30,21,본인,100세이상,196,190,6
2022-04-30,22,본인,해당없음,0,0,0
2022-04-30,23,유족,0~4세,0,0,0
2022-04-30,24,유족,5~9세,9,5,4
2022-04-30,25,유족,10~14세,9,8,1
2022-04-30,26,유족,15~19세,42,20,22
2022-04-30,27,유족,20~24세,74,42,32
2022-04-30,28,유족,25~29세,174,98,76
2022-04-30,29,유족,30~34세,335,184,151
2022-04-30,30,유족,35~39세,763,439,324
2022-04-30,31,유족,40~44세,2110,1274,836
2022-04-30,32,유족,45~49세,4660,2988,1672
2022-04-30,33,유족,50~54세,8369,5462,2907
2022-04-30,34,유족,55~59세,14327,9663,4664
2022-04-30,35,유족,60~64세,28699,18102,10597
2022-04-30,36,유족,65~69세,38930,19204,19726
2022-04-30,37,유족,70~74세,44690,17471,27219
2022-04-30,38,유족,75~79세,23630,6827,16803
2022-04-30,39,유족,80~84세,26239,3089,23150
2022-04-30,40,유족,85~89세,36724,1483,35241
2022-04-30,41,유족,90~94세,13910,450,13460
2022-04-30,42,유족,95~99세,1921,100,1821
2022-04-30,43,유족,100세이상,368,49,319
2022-04-30,44,유족,해당없음,7,1,6
2022-03-31,1,본인,0~4세,0,0,0
2022-03-31,2,본인,5~9세,0,0,0
2022-03-31,3,본인,10~14세,0,0,0
2022-03-31,4,본인,15~19세,0,0,0
2022-03-31,5,본인,20~24세,303,301,2
2022-03-31,6,본인,25~29세,5885,5614,271
2022-03-31,7,본인,30~34세,12595,11797,798
2022-03-31,8,본인,35~39세,13362,12672,690
2022-03-31,9,본인,40~44세,13498,12853,645
2022-03-31,10,본인,45~49세,13781,13399,382
2022-03-31,11,본인,50~54세,12659,12429,230
2022-03-31,12,본인,55~59세,19771,19500,271
2022-03-31,13,본인,60~64세,23913,23417,496
2022-03-31,14,본인,65~69세,25208,24978,230
2022-03-31,15,본인,70~74세,91555,91363,192
2022-03-31,16,본인,75~79세,101529,101365,164
2022-03-31,17,본인,80~84세,18704,18468,236
2022-03-31,18,본인,85~89세,29337,28544,793
2022-03-31,19,본인,90~94세,33313,32910,403
2022-03-31,20,본인,95~99세,3749,3716,33
2022-03-31,21,본인,100세이상,189,184,5
2022-03-31,22,본인,해당없음,0,0,0
2022-03-31,23,유족,0~4세,0,0,0
2022-03-31,24,유족,5~9세,9,5,4
2022-03-31,25,유족,10~14세,10,9,1
2022-03-31,26,유족,15~19세,41,19,22
2022-03-31,27,유족,20~24세,75,43,32
2022-03-31,28,유족,25~29세,173,96,77
2022-03-31,29,유족,30~34세,335,185,150
2022-03-31,30,유족,35~39세,775,446,329
2022-03-31,31,유족,40~44세,2096,1267,829
2022-03-31,32,유족,45~49세,4667,3002,1665
2022-03-31,33,유족,50~54세,8350,5437,2913
2022-03-31,34,유족,55~59세,14215,9577,4638
2022-03-31,35,유족,60~64세,28771,18130,10641
2022-03-31,36,유족,65~69세,38735,19005,19730
2022-03-31,37,유족,70~74세,44344,17370,26974
2022-03-31,38,유족,75~79세,23346,6696,16650
2022-03-31,39,유족,80~84세,26451,3064,23387
2022-03-31,40,유족,85~89세,36701,1467,35234
2022-03-31,41,유족,90~94세,13707,457,13250
2022-03-31,42,유족,95~99세,1912,105,1807
2022-03-31,43,유족,100세이상,368,51,317
2022-03-31,44,유족,해당없음,7,1,6
2022-02-28,1,본인,0~4세,0,0,0
2022-02-28,2,본인,5~9세,0,0,0
2022-02-28,3,본인,10~14세,0,0,0
2022-02-28,4,본인,15~19세,0,0,0
2022-02-28,5,본인,20~24세,305,304,1
2022-02-28,6,본인,25~29세,5801,5548,253
2022-02-28,7,본인,30~34세,12518,11731,787
2022-02-28,8,본인,35~39세,13415,12732,683
2022-02-28,9,본인,40~44세,13413,12774,639
2022-02-28,10,본인,45~49세,13733,13352,381
2022-02-28,11,본인,50~54세,12582,12359,223
2022-02-28,12,본인,55~59세,19785,19514,271
2022-02-28,13,본인,60~64세,24027,23534,493
2022-02-28,14,본인,65~69세,25253,25022,231
2022-02-28,15,본인,70~74세,93936,93741,195
2022-02-28,16,본인,75~79세,99768,99603,165
2022-02-28,17,본인,80~84세,18379,18140,239
2022-02-28,18,본인,85~89세,30785,29972,813
2022-02-28,19,본인,90~94세,32947,32558,389
2022-02-28,20,본인,95~99세,3655,3621,34
2022-02-28,21,본인,100세이상,186,181,5
2022-02-28,22,본인,해당없음,0,0,0
2022-02-28,23,유족,0~4세,0,0,0
2022-02-28,24,유족,5~9세,9,5,4
2022-02-28,25,유족,10~14세,10,9,1
2022-02-28,26,유족,15~19세,40,18,22
2022-02-28,27,유족,20~24세,76,43,33
2022-02-28,28,유족,25~29세,176,100,76
2022-02-28,29,유족,30~34세,331,180,151
2022-02-28,30,유족,35~39세,788,455,333
2022-02-28,31,유족,40~44세,2095,1270,825
2022-02-28,32,유족,45~49세,4683,3016,1667
2022-02-28,33,유족,50~54세,8385,5452,2933
2022-02-28,34,유족,55~59세,14173,9570,4603
2022-02-28,35,유족,60~64세,28909,18157,10752
2022-02-28,36,유족,65~69세,38603,18820,19783
2022-02-28,37,유족,70~74세,43958,17251,26707
2022-02-28,38,유족,75~79세,23042,6514,16528
2022-02-28,39,유족,80~84세,26788,3032,23756
2022-02-28,40,유족,85~89세,36571,1444,35127
2022-02-28,41,유족,90~94세,13390,451,12939
2022-02-28,42,유족,95~99세,1869,106,1763
2022-02-28,43,유족,100세이상,370,51,319
2022-02-28,44,유족,해당없음,7,1,6
2022-01-31,1,본인,0~4세,0,0,0
2022-01-31,2,본인,5~9세,0,0,0
2022-01-31,3,본인,10~14세,0,0,0
2022-01-31,4,본인,15~19세,1,1,0
2022-01-31,5,본인,20~24세,311,308,3
2022-01-31,6,본인,25~29세,5959,5686,273
2022-01-31,7,본인,30~34세,12501,11725,776
2022-01-31,8,본인,35~39세,13391,12723,668
2022-01-31,9,본인,40~44세,13341,12700,641
2022-01-31,10,본인,45~49세,13659,13288,371
2022-01-31,11,본인,50~54세,12584,12365,219
2022-01-31,12,본인,55~59세,19846,19576,270
2022-01-31,13,본인,60~64세,24017,23523,494
2022-01-31,14,본인,65~69세,25228,25001,227
2022-01-31,15,본인,70~74세,97028,96834,194
2022-01-31,16,본인,75~79세,97232,97068,164
2022-01-31,17,본인,80~84세,18040,17797,243
2022-01-31,18,본인,85~89세,32237,31408,829
2022-01-31,19,본인,90~94세,32506,32134,372
2022-01-31,20,본인,95~99세,3508,3474,34
2022-01-31,21,본인,100세이상,180,175,5
2022-01-31,22,본인,해당없음,0,0,0
2022-01-31,23,유족,0~4세,0,0,0
2022-01-31,24,유족,5~9세,9,5,4
2022-01-31,25,유족,10~14세,10,9,1
2022-01-31,26,유족,15~19세,40,18,22
2022-01-31,27,유족,20~24세,78,44,34
2022-01-31,28,유족,25~29세,181,105,76
2022-01-31,29,유족,30~34세,335,180,155
2022-01-31,30,유족,35~39세,802,460,342
2022-01-31,31,유족,40~44세,2108,1282,826
2022-01-31,32,유족,45~49세,4708,3037,1671
2022-01-31,33,유족,50~54세,8400,5453,2947
2022-01-31,34,유족,55~59세,14223,9607,4616
2022-01-31,35,유족,60~64세,29010,18198,10812
2022-01-31,36,유족,65~69세,38549,18655,19894
2022-01-31,37,유족,70~74세,43812,17170,26642
2022-01-31,38,유족,75~79세,22572,6312,16260
2022-01-31,39,유족,80~84세,27034,2989,24045
2022-01-31,40,유족,85~89세,36452,1429,35023
2022-01-31,41,유족,90~94세,13071,446,12625
2022-01-31,42,유족,95~99세,1829,111,1718
2022-01-31,43,유족,100세이상,367,50,317
2022-01-31,44,유족,해당없음,7,1,6
2021-12-31,1,본인,0~4세,0,0,0
2021-12-31,2,본인,5~9세,0,0,0
2021-12-31,3,본인,10~14세,0,0,0
2021-12-31,4,본인,15~19세,1,1,0
2021-12-31,5,본인,20~24세,312,309,3
2021-12-31,6,본인,25~29세,6076,5797,279
2021-12-31,7,본인,30~34세,12463,11679,784
2021-12-31,8,본인,35~39세,13385,12731,654
2021-12-31,9,본인,40~44세,13265,12632,633
2021-12-31,10,본인,45~49세,13523,13159,364
2021-12-31,11,본인,50~54세,12521,12303,218
2021-12-31,12,본인,55~59세,19910,19656,254
2021-12-31,13,본인,60~64세,23969,23489,480
2021-12-31,14,본인,65~69세,25296,25072,224
2021-12-31,15,본인,70~74세,99390,99193,197
2021-12-31,16,본인,75~79세,95440,95276,164
2021-12-31,17,본인,80~84세,17649,17402,247
2021-12-31,18,본인,85~89세,33898,33041,857
2021-12-31,19,본인,90~94세,31959,31608,351
2021-12-31,20,본인,95~99세,3399,3366,33
2021-12-31,21,본인,100세이상,172,167,5
2021-12-31,22,본인,해당없음,0,0,0
2021-12-31,23,유족,0~4세,0,0,0
2021-12-31,24,유족,5~9세,8,4,4
2021-12-31,25,유족,10~14세,10,9,1
2021-12-31,26,유족,15~19세,42,20,22
2021-12-31,27,유족,20~24세,72,42,30
2021-12-31,28,유족,25~29세,190,108,82
2021-12-31,29,유족,30~34세,327,176,151
2021-12-31,30,유족,35~39세,826,470,356
2021-12-31,31,유족,40~44세,2118,1295,823
2021-12-31,32,유족,45~49세,4731,3051,1680
2021-12-31,33,유족,50~54세,8372,5446,2926
2021-12-31,34,유족,55~59세,14360,9717,4643
2021-12-31,35,유족,60~64세,29079,18216,10863
2021-12-31,36,유족,65~69세,38359,18435,19924
2021-12-31,37,유족,70~74세,43506,17025,26481
2021-12-31,38,유족,75~79세,22313,6166,16147
2021-12-31,39,유족,80~84세,27343,2932,24411
2021-12-31,40,유족,85~89세,36356,1410,34946
2021-12-31,41,유족,90~94세,12719,430,12289
2021-12-31,42,유족,95~99세,1772,113,1659
2021-12-31,43,유족,100세이상,350,49,301
2021-12-31,44,유족,해당없음,6,0,0
2021-11-30,1,본인,0~4세,0,0,0
2021-11-30,2,본인,5~9세,0,0,0
2021-11-30,3,본인,10~14세,0,0,0
2021-11-30,4,본인,15~19세,1,1,0
2021-11-30,5,본인,20~24세,323,320,3
2021-11-30,6,본인,25~29세,6151,5866,285
2021-11-30,7,본인,30~34세,12423,11646,777
2021-11-30,8,본인,35~39세,13355,12705,650
2021-11-30,9,본인,40~44세,13267,12635,632
2021-11-30,10,본인,45~49세,13400,13043,357
2021-11-30,11,본인,50~54세,12578,12362,216
2021-11-30,12,본인,55~59세,19867,19614,253
2021-11-30,13,본인,60~64세,24071,23592,479
2021-11-30,14,본인,65~69세,25380,25159,221
2021-11-30,15,본인,70~74세,101787,101584,203
2021-11-30,16,본인,75~79세,93619,93458,161
2021-11-30,17,본인,80~84세,17487,17230,257
2021-11-30,18,본인,85~89세,35410,34540,870
2021-11-30,19,본인,90~94세,31543,31196,347
2021-11-30,20,본인,95~99세,3350,3318,32
2021-11-30,21,본인,100세이상,168,163,5
2021-11-30,22,본인,해당없음,0,0,0
2021-11-30,23,유족,0~4세,0,0,0
2021-11-30,24,유족,5~9세,8,4,4
2021-11-30,25,유족,10~14세,11,9,2
2021-11-30,26,유족,15~19세,42,21,21
2021-11-30,27,유족,20~24세,69,40,29
2021-11-30,28,유족,25~29세,199,110,89
2021-11-30,29,유족,30~34세,328,178,150
2021-11-30,30,유족,35~39세,830,472,358
2021-11-30,31,유족,40~44세,2122,1298,824
2021-11-30,32,유족,45~49세,4722,3059,1663
2021-11-30,33,유족,50~54세,8360,5443,2917
2021-11-30,34,유족,55~59세,14320,9682,4638
2021-11-30,35,유족,60~64세,29176,18217,10959
2021-11-30,36,유족,65~69세,38089,18221,19868
2021-11-30,37,유족,70~74세,43150,16867,26283
2021-11-30,38,유족,75~79세,22090,6047,16043
2021-11-30,39,유족,80~84세,27627,2926,24701
2021-11-30,40,유족,85~89세,36260,1390,34870
2021-11-30,41,유족,90~94세,12456,430,12026
2021-11-30,42,유족,95~99세,1761,112,1649
2021-11-30,43,유족,100세이상,346,47,299
2021-11-30,44,유족,해당없음,6,0,0
2021-10-31,1,본인,0~4세,0,0,0
2021-10-31,2,본인,5~9세,0,0,0
2021-10-31,3,본인,10~14세,0,0,0
2021-10-31,4,본인,15~19세,0,0,0
2021-10-31,5,본인,20~24세,337,333,4
2021-10-31,6,본인,25~29세,6236,5935,301
2021-10-31,7,본인,30~34세,12363,11597,766
2021-10-31,8,본인,35~39세,13352,12713,639
2021-10-31,9,본인,40~44세,13238,12604,634
2021-10-31,10,본인,45~49세,13299,12952,347
2021-10-31,11,본인,50~54세,12545,12328,217
2021-10-31,12,본인,55~59세,19878,19626,252
2021-10-31,13,본인,60~64세,24119,23635,484
2021-10-31,14,본인,65~69세,25468,25253,215
2021-10-31,15,본인,70~74세,103934,103732,202
2021-10-31,16,본인,75~79세,91905,91738,167
2021-10-31,17,본인,80~84세,17335,17073,262
2021-10-31,18,본인,85~89세,36636,35765,871
2021-10-31,19,본인,90~94세,31213,30868,345
2021-10-31,20,본인,95~99세,3305,3273,32
2021-10-31,21,본인,100세이상,166,161,5
2021-10-31,22,본인,해당없음,0,0,0
2021-10-31,23,유족,0~4세,0,0,0
2021-10-31,24,유족,5~9세,6,3,3
2021-10-31,25,유족,10~14세,13,11,2
2021-10-31,26,유족,15~19세,38,18,20
2021-10-31,27,유족,20~24세,66,38,28
2021-10-31,28,유족,25~29세,202,113,89
2021-10-31,29,유족,30~34세,328,177,151
2021-10-31,30,유족,35~39세,848,486,362
2021-10-31,31,유족,40~44세,2107,1284,823
2021-10-31,32,유족,45~49세,4717,3055,1662
2021-10-31,33,유족,50~54세,8336,5439,2897
2021-10-31,34,유족,55~59세,14355,9694,4661
2021-10-31,35,유족,60~64세,29227,18249,10978
2021-10-31,36,유족,65~69세,37855,18001,19854
2021-10-31,37,유족,70~74세,42819,16754,26065
2021-10-31,38,유족,75~79세,21874,5938,15936
2021-10-31,39,유족,80~84세,27914,2883,25031
2021-10-31,40,유족,85~89세,36093,1381,34712
2021-10-31,41,유족,90~94세,12266,437,11829
2021-10-31,42,유족,95~99세,1735,107,1628
2021-10-31,43,유족,100세이상,343,49,294
2021-10-31,44,유족,해당없음,4,0,4
2021-09-30,1,본인,0~4세,0,0,0
2021-09-30,2,본인,5~9세,0,0,0
2021-09-30,3,본인,10~14세,0,0,0
2021-09-30,4,본인,15~19세,0,0,0
2021-09-30,5,본인,20~24세,350,344,6
2021-09-30,6,본인,25~29세,6339,6030,309
2021-09-30,7,본인,30~34세,12327,11554,772
2021-09-30,8,본인,35~39세,13354,12736,618
2021-09-30,9,본인,40~44세,13159,12530,629
2021-09-30,10,본인,45~49세,13208,12868,340
2021-09-30,11,본인,50~54세,12549,12331,218
2021-09-30,12,본인,55~59세,19860,19617,243
2021-09-30,13,본인,60~64세,24219,23735,484
2021-09-30,14,본인,65~69세,25456,25242,214
2021-09-30,15,본인,70~74세,106183,105979,204
2021-09-30,16,본인,75~79세,90029,89861,168
2021-09-30,17,본인,80~84세,17219,16948,271
2021-09-30,18,본인,85~89세,37722,36837,885
2021-09-30,19,본인,90~94세,30758,30428,330
2021-09-30,20,본인,95~99세,3262,3231,31
2021-09-30,21,본인,100세이상,164,159,5
2021-09-30,22,본인,해당없음,0,0,0
2021-09-30,23,유족,0~4세,0,0,0
2021-09-30,24,유족,5~9세,7,4,3
2021-09-30,25,유족,10~14세,12,10,2
2021-09-30,26,유족,15~19세,38,18,20
2021-09-30,27,유족,20~24세,66,38,28
2021-09-30,28,유족,25~29세,201,111,90
2021-09-30,29,유족,30~34세,331,181,150
2021-09-30,30,유족,35~39세,853,480,373
2021-09-30,31,유족,40~44세,2114,1293,821
2021-09-30,32,유족,45~49세,4727,3069,1658
2021-09-30,33,유족,50~54세,8316,5439,2877
2021-09-30,34,유족,55~59세,14379,9700,4679
2021-09-30,35,유족,60~64세,29332,18283,11049
2021-09-30,36,유족,65~69세,37600,17788,19812
2021-09-30,37,유족,70~74세,42564,16650,25914
2021-09-30,38,유족,75~79세,21640,5815,15826
2021-09-30,39,유족,80~84세,28147,2854,25293
2021-09-30,40,유족,85~89세,35933,1373,34560
2021-09-30,41,유족,90~94세,12015,425,11590
2021-09-30,42,유족,95~99세,1709,104,1605
2021-09-30,43,유족,100세이상,338,48,290
2021-09-30,44,유족,해당없음,4,0,4
2021-08-31,1,본인,0~4세,0,0,0
2021-08-31,2,본인,5~9세,0,0,0
2021-08-31,3,본인,10~14세,1,1,0
2021-08-31,4,본인,15~19세,1,1,0
2021-08-31,5,본인,20~24세,336,330,6
2021-08-31,6,본인,25~29세,6401,6089,312
2021-08-31,7,본인,30~34세,12262,11489,773
2021-08-31,8,본인,35~39세,13350,12741,609
2021-08-31,9,본인,40~44세,13081,12458,623
2021-08-31,10,본인,45~49세,13183,12843,340
2021-08-31,11,본인,50~54세,12546,12330,216
2021-08-31,12,본인,55~59세,19808,19563,245
2021-08-31,13,본인,60~64세,24350,23868,482
2021-08-31,14,본인,65~69세,25424,25214,210
2021-08-31,15,본인,70~74세,108700,108490,210
2021-08-31,16,본인,75~79세,87898,87734,164
2021-08-31,17,본인,80~84세,17009,16737,272
2021-08-31,18,본인,85~89세,38838,37939,899
2021-08-31,19,본인,90~94세,30355,30029,326
2021-08-31,20,본인,95~99세,3193,3163,30
2021-08-31,21,본인,100세이상,161,156,5
2021-08-31,22,본인,해당없음,0,0,0
2021-08-31,23,유족,0~4세,0,0,0
2021-08-31,24,유족,5~9세,7,4,3
2021-08-31,25,유족,10~14세,12,10,2
2021-08-31,26,유족,15~19세,38,18,20
2021-08-31,27,유족,20~24세,65,37,28
2021-08-31,28,유족,25~29세,203,112,91
2021-08-31,29,유족,30~34세,332,184,148
2021-08-31,30,유족,35~39세,866,488,378
2021-08-31,31,유족,40~44세,2129,1298,831
2021-08-31,32,유족,45~49세,4736,3073,1663
2021-08-31,33,유족,50~54세,8315,5452,2863
2021-08-31,34,유족,55~59세,14359,9675,4684
2021-08-31,35,유족,60~64세,29473,18317,11156
2021-08-31,36,유족,65~69세,37338,17569,19769
2021-08-31,37,유족,70~74세,42415,16583,25832
2021-08-31,38,유족,75~79세,21408,5704,15704
2021-08-31,39,유족,80~84세,28381,2809,25572
2021-08-31,40,유족,85~89세,35790,1364,34426
2021-08-31,41,유족,90~94세,11806,420,11386
2021-08-31,42,유족,95~99세,1687,104,1583
2021-08-31,43,유족,100세이상,331,45,286
2021-08-31,44,유족,해당없음,4,0,4
2021-07-31,1,본인,0~4세,0,0,0
2021-07-31,2,본인,5~9세,0,0,0
2021-07-31,3,본인,10~14세,1,1,0
2021-07-31,4,본인,15~19세,1,1,0
2021-07-31,5,본인,20~24세,338,332,6
2021-07-31,6,본인,25~29세,6435,6116,319
2021-07-31,7,본인,30~34세,12198,11431,767
2021-07-31,8,본인,35~39세,13330,12723,607
2021-07-31,9,본인,40~44세,13065,12445,620
2021-07-31,10,본인,45~49세,13064,12730,334
2021-07-31,11,본인,50~54세,12507,12295,212
2021-07-31,12,본인,55~59세,19880,19634,246
2021-07-31,13,본인,60~64세,24390,23910,480
2021-07-31,14,본인,65~69세,25408,25201,207
2021-07-31,15,본인,70~74세,111285,111073,212
2021-07-31,16,본인,75~79세,85630,85467,163
2021-07-31,17,본인,80~84세,16887,16607,280
2021-07-31,18,본인,85~89세,40005,39102,903
2021-07-31,19,본인,90~94세,30039,29719,320
2021-07-31,20,본인,95~99세,3110,3083,27
2021-07-31,21,본인,100세이상,159,155,4
2021-07-31,22,본인,해당없음,0,0,0
2021-07-31,23,유족,0~4세,1,1,0
2021-07-31,24,유족,5~9세,6,3,3
2021-07-31,25,유족,10~14세,12,10,2
2021-07-31,26,유족,15~19세,38,18,20
2021-07-31,27,유족,20~24세,68,38,30
2021-07-31,28,유족,25~29세,201,112,89
2021-07-31,29,유족,30~34세,336,187,149
2021-07-31,30,유족,35~39세,876,494,382
2021-07-31,31,유족,40~44세,2160,1321,839
2021-07-31,32,유족,45~49세,4697,3056,1641
2021-07-31,33,유족,50~54세,8279,5421,2858
2021-07-31,34,유족,55~59세,14390,9714,4676
2021-07-31,35,유족,60~64세,29512,18288,11224
2021-07-31,36,유족,65~69세,37167,17408,19759
2021-07-31,37,유족,70~74세,42099,16435,25664
2021-07-31,38,유족,75~79세,21145,5589,15556
2021-07-31,39,유족,80~84세,28568,2782,25786
2021-07-31,40,유족,85~89세,35702,1346,34356
2021-07-31,41,유족,90~94세,11609,423,11186
2021-07-31,42,유족,95~99세,1686,103,1583
2021-07-31,43,유족,100세이상,327,43,284
2021-07-31,44,유족,해당없음,5,1,4
2021-06-30,1,본인,0~4세,0,0,0
2021-06-30,2,본인,5~9세,0,0,0
2021-06-30,3,본인,10~14세,1,1,0
2021-06-30,4,본인,15~19세,2,2,0
2021-06-30,5,본인,20~24세,344,338,6
2021-06-30,6,본인,25~29세,6355,6034,321
2021-06-30,7,본인,30~34세,12101,11337,764
2021-06-30,8,본인,35~39세,13328,12728,600
2021-06-30,9,본인,40~44세,12952,12337,615
2021-06-30,10,본인,45~49세,13011,12680,331
2021-06-30,11,본인,50~54세,12438,12229,209
2021-06-30,12,본인,55~59세,19916,19666,250
2021-06-30,13,본인,60~64세,24287,23826,461
2021-06-30,14,본인,65~69세,25469,25263,206
2021-06-30,15,본인,70~74세,113477,113264,213
2021-06-30,16,본인,75~79세,83741,83580,161
2021-06-30,17,본인,80~84세,16836,16552,284
2021-06-30,18,본인,85~89세,41101,40193,908
2021-06-30,19,본인,90~94세,29770,29453,317
2021-06-30,20,본인,95~99세,3070,3043,27
2021-06-30,21,본인,100세이상,162,158,4
2021-06-30,22,본인,해당없음,0,0,0
2021-06-30,23,유족,0~4세,1,1,0
2021-06-30,24,유족,5~9세,6,3,3
2021-06-30,25,유족,10~14세,12,10,2
2021-06-30,26,유족,15~19세,37,19,18
2021-06-30,27,유족,20~24세,66,36,30
2021-06-30,28,유족,25~29세,204,115,89
2021-06-30,29,유족,30~34세,339,185,154
2021-06-30,30,유족,35~39세,877,496,381
2021-06-30,31,유족,40~44세,2168,1330,838
2021-06-30,32,유족,45~49세,4711,3071,1640
2021-06-30,33,유족,50~54세,8243,5406,2837
2021-06-30,34,유족,55~59세,14385,9708,4677
2021-06-30,35,유족,60~64세,29453,18206,11247
2021-06-30,36,유족,65~69세,37023,17251,19772
2021-06-30,37,유족,70~74세,41760,16283,25477
2021-06-30,38,유족,75~79세,20902,5508,15394
2021-06-30,39,유족,80~84세,28735,2753,25982
2021-06-30,40,유족,85~89세,35564,1345,34219
2021-06-30,41,유족,90~94세,11473,421,11052
2021-06-30,42,유족,95~99세,1686,106,1580
2021-06-30,43,유족,100세이상,327,44,283
2021-06-30,44,유족,해당없음,5,1,4
2021-05-31,1,본인,0~4세,0,0,0
2021-05-31,2,본인,5~9세,0,0,0
2021-05-31,3,본인,10~14세,0,0,0
2021-05-31,4,본인,15~19세,1,1,0
2021-05-31,5,본인,20~24세,345,338,7
2021-05-31,6,본인,25~29세,6351,6029,322
2021-05-31,7,본인,30~34세,12067,11317,750
2021-05-31,8,본인,35~39세,13312,12714,598
2021-05-31,9,본인,40~44세,12852,12244,608
2021-05-31,10,본인,45~49세,12959,12627,332
2021-05-31,11,본인,50~54세,12393,12193,200
2021-05-31,12,본인,55~59세,19991,19736,255
2021-05-31,13,본인,60~64세,24247,23792,455
2021-05-31,14,본인,65~69세,25490,25281,209
2021-05-31,15,본인,70~74세,115488,115277,211
2021-05-31,16,본인,75~79세,82124,81962,162
2021-05-31,17,본인,80~84세,16739,16450,289
2021-05-31,18,본인,85~89세,42051,41137,914
2021-05-31,19,본인,90~94세,29655,29345,310
2021-05-31,20,본인,95~99세,3060,3034,26
2021-05-31,21,본인,100세이상,163,159,4
2021-05-31,22,본인,해당없음,0,0,0
2021-05-31,23,유족,0~4세,1,1,0
2021-05-31,24,유족,5~9세,6,3,3
2021-05-31,25,유족,10~14세,12,10,2
2021-05-31,26,유족,15~19세,38,20,18
2021-05-31,27,유족,20~24세,66,35,31
2021-05-31,28,유족,25~29세,202,115,87
2021-05-31,29,유족,30~34세,345,189,156
2021-05-31,30,유족,35~39세,886,501,385
2021-05-31,31,유족,40~44세,2157,1322,835
2021-05-31,32,유족,45~49세,4725,3074,1651
2021-05-31,33,유족,50~54세,8234,5410,2824
2021-05-31,34,유족,55~59세,14463,9762,4701
2021-05-31,35,유족,60~64세,29301,18068,11233
2021-05-31,36,유족,65~69세,36831,17118,19713
2021-05-31,37,유족,70~74세,41436,16158,25278
2021-05-31,38,유족,75~79세,20753,5414,15339
2021-05-31,39,유족,80~84세,28836,2746,26090
2021-05-31,40,유족,85~89세,35396,1325,34071
2021-05-31,41,유족,90~94세,11366,427,10939
2021-05-31,42,유족,95~99세,1669,104,1565
2021-05-31,43,유족,100세이상,324,43,281
2021-05-31,44,유족,해당없음,5,1,4
2021-04-30,1,본인,0~4세,0,0,0
2021-04-30,2,본인,5~9세,0,0,0
2021-04-30,3,본인,10~14세,0,0,0
2021-04-30,4,본인,15~19세,1,1,0
2021-04-30,5,본인,20~24세,338,331,7
2021-04-30,6,본인,25~29세,6382,6061,321
2021-04-30,7,본인,30~34세,12087,11332,755
2021-04-30,8,본인,35~39세,13280,12690,590
2021-04-30,9,본인,40~44세,12758,12161,597
2021-04-30,10,본인,45~49세,12982,12655,327
2021-04-30,11,본인,50~54세,12291,12093,198
2021-04-30,12,본인,55~59세,20109,19843,266
2021-04-30,13,본인,60~64세,24196,23751,445
2021-04-30,14,본인,65~69세,25518,25312,206
2021-04-30,15,본인,70~74세,117572,117359,213
2021-04-30,16,본인,75~79세,80264,80104,160
2021-04-30,17,본인,80~84세,16669,16371,298
2021-04-30,18,본인,85~89세,43098,42181,917
2021-04-30,19,본인,90~94세,29340,29034,306
2021-04-30,20,본인,95~99세,2986,2962,24
2021-04-30,21,본인,100세이상,157,153,4
2021-04-30,22,본인,해당없음,0,0,0
2021-04-30,23,유족,0~4세,1,1,0
2021-04-30,24,유족,5~9세,6,3,3
2021-04-30,25,유족,10~14세,12,10,2
2021-04-30,26,유족,15~19세,39,20,19
2021-04-30,27,유족,20~24세,67,36,31
2021-04-30,28,유족,25~29세,203,116,87
2021-04-30,29,유족,30~34세,347,189,158
2021-04-30,30,유족,35~39세,893,503,390
2021-04-30,31,유족,40~44세,2167,1336,831
2021-04-30,32,유족,45~49세,4755,3086,1669
2021-04-30,33,유족,50~54세,8198,5409,2789
2021-04-30,34,유족,55~59세,14597,9817,4780
2021-04-30,35,유족,60~64세,29288,18036,11252
2021-04-30,36,유족,65~69세,36686,16957,19729
2021-04-30,37,유족,70~74세,41065,16009,25056
2021-04-30,38,유족,75~79세,20593,5319,15274
2021-04-30,39,유족,80~84세,29139,2737,26402
2021-04-30,40,유족,85~89세,35139,1312,33827
2021-04-30,41,유족,90~94세,11141,422,10719
2021-04-30,42,유족,95~99세,1660,107,1553
2021-04-30,43,유족,100세이상,321,42,279
2021-04-30,44,유족,해당없음,5,1,4
2021-03-31,1,본인,0~4세,0,0,0
2021-03-31,2,본인,5~9세,0,0,0
2021-03-31,3,본인,10~14세,0,0,0
2021-03-31,4,본인,15~19세,0,0,0
2021-03-31,5,본인,20~24세,346,338,8
2021-03-31,6,본인,25~29세,6436,6121,315
2021-03-31,7,본인,30~34세,12068,11308,760
2021-03-31,8,본인,35~39세,13264,12684,580
2021-03-31,9,본인,40~44세,12747,12151,596
2021-03-31,10,본인,45~49세,12890,12565,325
2021-03-31,11,본인,50~54세,12210,12018,192
2021-03-31,12,본인,55~59세,20110,19841,269
2021-03-31,13,본인,60~64세,24242,23798,444
2021-03-31,14,본인,65~69세,25505,25305,200
2021-03-31,15,본인,70~74세,119409,119194,215
2021-03-31,16,본인,75~79세,78844,78684,160
2021-03-31,17,본인,80~84세,16582,16277,305
2021-03-31,18,본인,85~89세,44260,43342,918
2021-03-31,19,본인,90~94세,29080,28776,304
2021-03-31,20,본인,95~99세,2925,2904,21
2021-03-31,21,본인,100세이상,153,149,4
2021-03-31,22,본인,해당없음,0,0,0
2021-03-31,23,유족,0~4세,1,1,0
2021-03-31,24,유족,5~9세,6,3,3
2021-03-31,25,유족,10~14세,12,10,2
2021-03-31,26,유족,15~19세,39,20,19
2021-03-31,27,유족,20~24세,65,34,31
2021-03-31,28,유족,25~29세,203,116,87
2021-03-31,29,유족,30~34세,355,191,164
2021-03-31,30,유족,35~39세,898,504,394
2021-03-31,31,유족,40~44세,2180,1346,834
2021-03-31,32,유족,45~49세,4745,3086,1659
2021-03-31,33,유족,50~54세,8170,5384,2786
2021-03-31,34,유족,55~59세,14584,9799,4785
2021-03-31,35,유족,60~64세,29207,17933,11274
2021-03-31,36,유족,65~69세,36545,16855,19690
2021-03-31,37,유족,70~74세,40620,15811,24809
2021-03-31,38,유족,75~79세,20493,5263,15230
2021-03-31,39,유족,80~84세,29512,2735,26777
2021-03-31,40,유족,85~89세,34875,1296,33579
2021-03-31,41,유족,90~94세,10956,420,10536
2021-03-31,42,유족,95~99세,1639,112,1527
2021-03-31,43,유족,100세이상,315,41,274
2021-03-31,44,유족,해당없음,5,1,4
2021-02-28,1,본인,0~4세,0,0,0
2021-02-28,2,본인,5~9세,0,0,0
2021-02-28,3,본인,10~14세,0,0,0
2021-02-28,4,본인,15~19세,1,1,0
2021-02-28,5,본인,20~24세,350,342,8
2021-02-28,6,본인,25~29세,6409,6112,297
2021-02-28,7,본인,30~34세,12024,11270,754
2021-02-28,8,본인,35~39세,13304,12732,572
2021-02-28,9,본인,40~44세,12703,12110,593
2021-02-28,10,본인,45~49세,12806,12489,317
2021-02-28,11,본인,50~54세,12311,12115,196
2021-02-28,12,본인,55~59세,20072,19803,269
2021-02-28,13,본인,60~64세,24248,23811,437
2021-02-28,14,본인,65~69세,25501,25301,200
2021-02-28,15,본인,70~74세,121754,121536,218
2021-02-28,16,본인,75~79세,76860,76700,160
2021-02-28,17,본인,80~84세,16545,16238,307
2021-02-28,18,본인,85~89세,45520,44592,928
2021-02-28,19,본인,90~94세,28604,28308,296
2021-02-28,20,본인,95~99세,2822,2802,20
2021-02-28,21,본인,100세이상,152,148,4
2021-02-28,22,본인,해당없음,0,0,0
2021-02-28,23,유족,0~4세,1,1,0
2021-02-28,24,유족,5~9세,6,3,3
2021-02-28,25,유족,10~14세,12,11,1
2021-02-28,26,유족,15~19세,40,20,20
2021-02-28,27,유족,20~24세,66,35,31
2021-02-28,28,유족,25~29세,205,117,88
2021-02-28,29,유족,30~34세,354,191,163
2021-02-28,30,유족,35~39세,890,497,393
2021-02-28,31,유족,40~44세,2186,1347,839
2021-02-28,32,유족,45~49세,4739,3084,1655
2021-02-28,33,유족,50~54세,8185,5394,2791
2021-02-28,34,유족,55~59세,14626,9797,4829
2021-02-28,35,유족,60~64세,29163,17854,11309
2021-02-28,36,유족,65~69세,36370,16660,19710
2021-02-28,37,유족,70~74세,40082,15579,24503
2021-02-28,38,유족,75~79세,20460,5203,15257
2021-02-28,39,유족,80~84세,29914,2725,27189
2021-02-28,40,유족,85~89세,34480,1270,33210
2021-02-28,41,유족,90~94세,10710,419,10291
2021-02-28,42,유족,95~99세,1611,113,1498
2021-02-28,43,유족,100세이상,316,40,276
2021-02-28,44,유족,해당없음,7,2,5
2021-01-31,1,본인,0~4세,0,0,0
2021-01-31,2,본인,5~9세,0,0,0
2021-01-31,3,본인,10~14세,0,0,0
2021-01-31,4,본인,15~19세,1,1,0
2021-01-31,5,본인,20~24세,369,361,8
2021-01-31,6,본인,25~29세,6547,6239,308
2021-01-31,7,본인,30~34세,12062,11312,750
2021-01-31,8,본인,35~39세,13309,12739,570
2021-01-31,9,본인,40~44세,12596,12013,583
2021-01-31,10,본인,45~49세,12729,12417,312
2021-01-31,11,본인,50~54세,12306,12116,190
2021-01-31,12,본인,55~59세,20126,19857,269
2021-01-31,13,본인,60~64세,24256,23820,436
2021-01-31,14,본인,65~69세,25550,25353,197
2021-01-31,15,본인,70~74세,123485,123263,222
2021-01-31,16,본인,75~79세,75377,75212,165
2021-01-31,17,본인,80~84세,16493,16179,314
2021-01-31,18,본인,85~89세,46666,45733,933
2021-01-31,19,본인,90~94세,28182,27899,283
2021-01-31,20,본인,95~99세,2701,2682,19
2021-01-31,21,본인,100세이상,155,151,4
2021-01-31,22,본인,해당없음,0,0,0
2021-01-31,23,유족,0~4세,1,1,0
2021-01-31,24,유족,5~9세,6,3,3
2021-01-31,25,유족,10~14세,12,11,1
2021-01-31,26,유족,15~19세,40,20,20
2021-01-31,27,유족,20~24세,67,35,32
2021-01-31,28,유족,25~29세,203,114,89
2021-01-31,29,유족,30~34세,364,197,167
2021-01-31,30,유족,35~39세,898,507,391
2021-01-31,31,유족,40~44세,2202,1351,851
2021-01-31,32,유족,45~49세,4732,3071,1661
2021-01-31,33,유족,50~54세,8200,5424,2776
2021-01-31,34,유족,55~59세,14710,9819,4891
2021-01-31,35,유족,60~64세,29112,17806,11306
2021-01-31,36,유족,65~69세,36325,16551,19774
2021-01-31,37,유족,70~74세,39505,15297,24208
2021-01-31,38,유족,75~79세,20446,5148,15298
2021-01-31,39,유족,80~84세,30239,2713,27526
2021-01-31,40,유족,85~89세,34155,1253,32902
2021-01-31,41,유족,90~94세,10504,422,10082
2021-01-31,42,유족,95~99세,1565,112,1453
2021-01-31,43,유족,100세이상,318,41,277
2021-01-31,44,유족,해당없음,7,2,5
2020-12-31,1,본인,0~4세,0,0,0
2020-12-31,2,본인,5~9세,0,0,0
2020-12-31,3,본인,10~14세,0,0,0
2020-12-31,4,본인,15~19세,1,1,0
2020-12-31,5,본인,20~24세,380,371,9
2020-12-31,6,본인,25~29세,6629,6315,314
2020-12-31,7,본인,30~34세,12034,11294,740
2020-12-31,8,본인,35~39세,13316,12745,571
2020-12-31,9,본인,40~44세,12529,11962,567
2020-12-31,10,본인,45~49세,12600,12293,307
2020-12-31,11,본인,50~54세,12262,12068,194
2020-12-31,12,본인,55~59세,20179,19915,264
2020-12-31,13,본인,60~64세,24220,23804,416
2020-12-31,14,본인,65~69세,25630,25435,195
2020-12-31,15,본인,70~74세,125158,124936,222
2020-12-31,16,본인,75~79세,73869,73704,165
2020-12-31,17,본인,80~84세,16454,16132,322
2020-12-31,18,본인,85~89세,48042,47100,942
2020-12-31,19,본인,90~94세,27690,27413,277
2020-12-31,20,본인,95~99세,2606,2587,19
2020-12-31,21,본인,100세이상,154,150,4
2020-12-31,22,본인,해당없음,0,0,0
2020-12-31,23,유족,0~4세,1,1,0
2020-12-31,24,유족,5~9세,6,3,3
2020-12-31,25,유족,10~14세,12,11,1
2020-12-31,26,유족,15~19세,45,22,23
2020-12-31,27,유족,20~24세,67,36,31
2020-12-31,28,유족,25~29세,204,115,89
2020-12-31,29,유족,30~34세,365,197,168
2020-12-31,30,유족,35~39세,910,517,393
2020-12-31,31,유족,40~44세,2220,1361,859
2020-12-31,32,유족,45~49세,4751,3091,1660
2020-12-31,33,유족,50~54세,8207,5434,2773
2020-12-31,34,유족,55~59세,14799,9870,4929
2020-12-31,35,유족,60~64세,29113,17756,11357
2020-12-31,36,유족,65~69세,36382,16535,19847
2020-12-31,37,유족,70~74세,38678,14908,23770
2020-12-31,38,유족,75~79세,20399,5085,15314
2020-12-31,39,유족,80~84세,30570,2681,27889
2020-12-31,40,유족,85~89세,33882,1244,32638
2020-12-31,41,유족,90~94세,10278,421,9857
2020-12-31,42,유족,95~99세,1532,113,1419
2020-12-31,43,유족,100세이상,311,40,271
2020-12-31,44,유족,해당없음,7,2,5
2020-11-30,1,본인,0~4세,0,0,0
2020-11-30,2,본인,5~9세,0,0,0
2020-11-30,3,본인,10~14세,0,0,0
2020-11-30,4,본인,15~19세,1,1,0
2020-11-30,5,본인,20~24세,387,380,7
2020-11-30,6,본인,25~29세,6692,6392,300
2020-11-30,7,본인,30~34세,12002,11261,741
2020-11-30,8,본인,35~39세,13306,12738,568
2020-11-30,9,본인,40~44세,12479,11922,557
2020-11-30,10,본인,45~49세,12519,12213,306
2020-11-30,11,본인,50~54세,12304,12113,191
2020-11-30,12,본인,55~59세,20204,19940,264
2020-11-30,13,본인,60~64세,24261,23845,416
2020-11-30,14,본인,65~69세,26417,26224,193
2020-11-30,15,본인,70~74세,125674,125453,221
2020-11-30,16,본인,75~79세,72864,72696,168
2020-11-30,17,본인,80~84세,16414,16076,338
2020-11-30,18,본인,85~89세,49012,48074,938
2020-11-30,19,본인,90~94세,27194,26926,268
2020-11-30,20,본인,95~99세,2553,2536,17
2020-11-30,21,본인,100세이상,149,145,4
2020-11-30,22,본인,해당없음,0,0,0
2020-11-30,23,유족,0~4세,1,1,0
2020-11-30,24,유족,5~9세,6,3,3
2020-11-30,25,유족,10~14세,12,11,1
2020-11-30,26,유족,15~19세,48,24,24
2020-11-30,27,유족,20~24세,66,36,30
2020-11-30,28,유족,25~29세,204,113,91
2020-11-30,29,유족,30~34세,371,202,169
2020-11-30,30,유족,35~39세,900,510,390
2020-11-30,31,유족,40~44세,2265,1390,875
2020-11-30,32,유족,45~49세,4736,3080,1656
2020-11-30,33,유족,50~54세,8222,5433,2789
2020-11-30,34,유족,55~59세,14838,9890,4948
2020-11-30,35,유족,60~64세,29142,17696,11446
2020-11-30,36,유족,65~69세,36404,16467,19937
2020-11-30,37,유족,70~74세,38023,14667,23356
2020-11-30,38,유족,75~79세,20445,5058,15387
2020-11-30,39,유족,80~84세,31046,2666,28380
2020-11-30,40,유족,85~89세,33445,1209,32236
2020-11-30,41,유족,90~94세,10029,415,9614
2020-11-30,42,유족,95~99세,1513,114,1399
2020-11-30,43,유족,100세이상,307,40,267
2020-11-30,44,유족,해당없음,7,2,5
2020-10-31,1,본인,0~4세,0,0,0
2020-10-31,2,본인,5~9세,0,0,0
2020-10-31,3,본인,10~14세,0,0,0
2020-10-31,4,본인,15~19세,1,1,0
2020-10-31,5,본인,20~24세,401,394,7
2020-10-31,6,본인,25~29세,6754,6445,309
2020-10-31,7,본인,30~34세,11983,11244,739
2020-10-31,8,본인,35~39세,13279,12710,569
2020-10-31,9,본인,40~44세,12430,11880,550
2020-10-31,10,본인,45~49세,12441,12142,299
2020-10-31,11,본인,50~54세,12302,12112,190
2020-10-31,12,본인,55~59세,20219,19956,263
2020-10-31,13,본인,60~64세,24257,23849,408
2020-10-31,14,본인,65~69세,27231,27036,195
2020-10-31,15,본인,70~74세,126174,125953,221
2020-10-31,16,본인,75~79세,72016,71846,170
2020-10-31,17,본인,80~84세,16386,16043,343
2020-10-31,18,본인,85~89세,50168,49223,945
2020-10-31,19,본인,90~94세,26916,26658,258
2020-10-31,20,본인,95~99세,2519,2502,17
2020-10-31,21,본인,100세이상,146,142,4
2020-10-31,22,본인,해당없음,0,0,0
2020-10-31,23,유족,0~4세,2,2,0
2020-10-31,24,유족,5~9세,5,2,3
2020-10-31,25,유족,10~14세,13,12,1
2020-10-31,26,유족,15~19세,47,23,24
2020-10-31,27,유족,20~24세,69,38,31
2020-10-31,28,유족,25~29세,202,113,89
2020-10-31,29,유족,30~34세,372,204,168
2020-10-31,30,유족,35~39세,910,509,401
2020-10-31,31,유족,40~44세,2279,1406,873
2020-10-31,32,유족,45~49세,4735,3069,1666
2020-10-31,33,유족,50~54세,8186,5417,2769
2020-10-31,34,유족,55~59세,14884,9915,4969
2020-10-31,35,유족,60~64세,29028,17569,11459
2020-10-31,36,유족,65~69세,36410,16410,20000
2020-10-31,37,유족,70~74세,37318,14354,22964
2020-10-31,38,유족,75~79세,20419,5035,15384
2020-10-31,39,유족,80~84세,31393,2654,28739
2020-10-31,40,유족,85~89세,33149,1193,31956
2020-10-31,41,유족,90~94세,9913,420,9493
2020-10-31,42,유족,95~99세,1502,111,1391
2020-10-31,43,유족,100세이상,305,40,265
2020-10-31,44,유족,해당없음,7,2,5
2020-09-30,1,본인,0~4세,0,0,0
2020-09-30,2,본인,5~9세,0,0,0
2020-09-30,3,본인,10~14세,0,0,0
2020-09-30,4,본인,15~19세,1,1,0
2020-09-30,5,본인,20~24세,413,407,6
2020-09-30,6,본인,25~29세,6835,6515,320
2020-09-30,7,본인,30~34세,11950,11215,735
2020-09-30,8,본인,35~39세,13290,12729,561
2020-09-30,9,본인,40~44세,12351,11810,541
2020-09-30,10,본인,45~49세,12387,12093,294
2020-09-30,11,본인,50~54세,12352,12165,187
2020-09-30,12,본인,55~59세,20171,19913,258
2020-09-30,13,본인,60~64세,24298,23890,408
2020-09-30,14,본인,65~69세,27996,27804,192
2020-09-30,15,본인,70~74세,126802,126580,222
2020-09-30,16,본인,75~79세,71018,70845,173
2020-09-30,17,본인,80~84세,16356,16003,353
2020-09-30,18,본인,85~89세,51285,50341,944
2020-09-30,19,본인,90~94세,26575,26327,248
2020-09-30,20,본인,95~99세,2469,2452,17
2020-09-30,21,본인,100세이상,143,138,5
2020-09-30,22,본인,해당없음,0,0,0
2020-09-30,23,유족,0~4세,2,2,0
2020-09-30,24,유족,5~9세,5,2,3
2020-09-30,25,유족,10~14세,13,12,1
2020-09-30,26,유족,15~19세,47,22,25
2020-09-30,27,유족,20~24세,68,38,30
2020-09-30,28,유족,25~29세,205,114,91
2020-09-30,29,유족,30~34세,370,202,168
2020-09-30,30,유족,35~39세,924,519,405
2020-09-30,31,유족,40~44세,2279,1405,874
2020-09-30,32,유족,45~49세,4779,3096,1683
2020-09-30,33,유족,50~54세,8157,5406,2751
2020-09-30,34,유족,55~59세,14928,9926,5002
2020-09-30,35,유족,60~64세,29009,17543,11466
2020-09-30,36,유족,65~69세,36378,16323,20055
2020-09-30,37,유족,70~74세,36660,14069,22591
2020-09-30,38,유족,75~79세,20418,4990,15428
2020-09-30,39,유족,80~84세,31702,2653,29049
2020-09-30,40,유족,85~89세,32803,1176,31627
2020-09-30,41,유족,90~94세,9748,418,9330
2020-09-30,42,유족,95~99세,1489,110,1379
2020-09-30,43,유족,100세이상,301,41,260
2020-09-30,44,유족,해당없음,6,1,5
